DataTime,Hosts,Guests,1PHosts,2PHosts,3PHosts,OTHosts,SSHosts,CountHosts,1PGuests,2PGuests,3PGuests,OTGuests,SSGuests,CountGuests
2018-10-04,Торонто,Монреаль,1,1,0,1,0,3,1,1,0,0,0,2
2018-10-04,Вашингтон,Бостон,2,4,1,0,0,7,0,0,0,0,0,0
2018-10-04,Ванкувер,Калгари,1,0,4,0,0,5,0,0,2,0,0,2
2018-10-04,Сан-Хосе,Анахайм,1,1,0,0,0,2,1,1,3,0,0,5
2018-10-05,Баффало,Бостон,0,0,0,0,0,0,2,1,1,0,0,4
2018-10-05,Питтсбург,Вашингтон,2,3,1,1,0,7,3,1,2,0,0,6
2018-10-05,Каролина,Айлендерс,0,0,1,0,0,1,0,1,0,1,0,2
2018-10-05,Детройт,Коламбус,0,2,0,0,0,2,1,1,0,1,0,3
2018-10-05,Оттава,Чикаго,3,0,0,0,0,3,2,0,1,1,0,4
2018-10-05,Рейнджерс,Нэшвилл,0,1,1,0,0,2,0,1,2,0,0,3
2018-10-05,Сент-Луис,Виннипег,0,0,1,0,0,1,1,0,4,0,0,5
2018-10-05,Даллас,Аризона,0,3,0,0,0,3,0,0,0,0,0,0
2018-10-05,Колорадо,Миннесота,1,1,2,0,0,4,1,0,0,0,0,1
2018-10-05,Вегас,Филадельфия,1,0,1,0,0,2,2,3,0,0,0,5
2018-10-06,Коламбус,Каролина,1,0,0,0,0,1,1,1,1,0,0,3
2018-10-06,Лос-Анджелес,Сан-Хосе,1,1,0,0,0,2,2,0,0,1,0,3
2018-10-06,Нью-Джерси,Эдмонтон,1,2,2,0,0,5,1,0,1,0,0,2
2018-10-07,Даллас,Виннипег,2,1,2,0,0,5,0,1,0,0,0,1
2018-10-07,Тампа-Бэй,Флорида,0,0,1,0,1,2,1,0,0,0,0,1
2018-10-07,Баффало,Рейнджерс,1,1,1,0,0,3,0,0,1,0,0,1
2018-10-07,Айлендерс,Нэшвилл,1,2,0,0,0,3,2,2,0,0,0,4
2018-10-07,Торонто,Оттава,0,3,0,0,0,3,1,2,2,0,0,5
2018-10-07,Питтсбург,Монреаль,0,1,0,0,0,1,2,2,1,0,0,5
2018-10-07,Сент-Луис,Чикаго,2,0,2,0,0,4,1,2,1,1,0,5
2018-10-07,Миннесота,Вегас,1,0,0,0,0,1,0,0,1,0,1,2
2018-10-07,Аризона,Анахайм,0,0,0,0,0,0,0,1,0,0,0,1
2018-10-07,Колорадо,Филадельфия,2,1,2,0,0,5,1,1,0,0,0,2
2018-10-07,Калгари,Ванкувер,2,1,4,0,0,7,2,2,0,0,0,4
2018-10-08,Каролина,Рейнджерс,2,2,4,0,0,8,2,2,1,0,0,5
2018-10-08,Чикаго,Торонто,2,1,3,0,0,6,2,2,2,1,0,7
2018-10-08,Лос-Анджелес,Детройт,0,2,2,0,0,4,0,1,1,0,0,2
2018-10-08,Бостон,Оттава,2,1,3,0,0,6,0,2,1,0,0,3
2018-10-08,Айлендерс,Сан-Хосе,0,1,3,0,0,4,0,0,0,0,0,0
2018-10-08,Баффало,Вегас,1,3,0,0,0,4,0,1,1,0,0,2
2018-10-09,Анахайм,Детройт,0,1,1,0,1,3,1,1,0,0,0,2
2018-10-10,Каролина,Ванкувер,3,1,1,0,0,5,1,2,0,0,0,3
2018-10-10,Филадельфия,Сан-Хосе,0,1,1,0,0,2,4,1,3,0,0,8
2018-10-10,Коламбус,Колорадо,2,0,3,0,0,5,0,2,0,0,0,2
2018-10-10,Виннипег,Лос-Анджелес,1,1,0,0,0,2,1,0,0,0,0,1
2018-10-10,Нэшвилл,Калгари,0,0,0,0,0,0,1,1,1,0,0,3
2018-10-10,Даллас,Торонто,1,2,1,0,0,4,2,3,2,0,0,7
2018-10-11,Оттава,Филадельфия,1,2,1,0,0,4,1,3,3,0,0,7
2018-10-11,Вашингтон,Вегас,1,1,3,0,0,5,0,1,1,0,0,2
2018-10-11,Анахайм,Аризона,1,1,0,0,0,2,1,1,0,0,1,3
2018-10-12,Питтсбург,Вегас,1,3,0,0,0,4,1,0,1,0,0,2
2018-10-12,Рейнджерс,Сан-Хосе,1,0,1,1,0,3,1,1,0,0,0,2
2018-10-12,Флорида,Коламбус,1,3,0,0,0,4,2,1,2,0,0,5
2018-10-12,Нью-Джерси,Вашингтон,2,1,3,0,0,6,0,0,0,0,0,0
2018-10-12,Бостон,Эдмонтон,3,0,1,0,0,4,1,0,0,0,0,1
2018-10-12,Баффало,Колорадо,0,1,0,0,0,1,3,1,2,0,0,6
2018-10-12,Тампа-Бэй,Ванкувер,1,0,0,0,0,1,0,0,4,0,0,4
2018-10-12,Монреаль,Лос-Анджелес,0,0,0,0,0,0,2,0,1,0,0,3
2018-10-12,Детройт,Торонто,1,0,2,0,0,3,1,2,2,0,0,5
2018-10-12,Миннесота,Чикаго,0,2,1,1,0,4,2,0,1,0,0,3
2018-10-12,Нэшвилл,Виннипег,0,1,2,0,0,3,0,0,0,0,0,0
2018-10-12,Сент-Луис,Калгари,3,2,0,0,0,5,1,0,2,0,0,3
2018-10-13,Рейнджерс,Эдмонтон,1,0,0,0,0,1,1,0,1,0,0,2
2018-10-13,Филадельфия,Вегас,0,0,0,0,0,0,0,0,1,0,0,1
2018-10-13,Оттава,Лос-Анджелес,3,1,1,0,0,5,0,1,0,0,0,1
2018-10-13,Бостон,Детройт,1,3,4,0,0,8,0,0,2,0,0,2
2018-10-14,Миннесота,Каролина,1,0,3,0,0,4,1,1,2,1,0,5
2018-10-14,Тампа-Бэй,Коламбус,3,1,4,0,0,8,0,2,0,0,0,2
2018-10-14,Монреаль,Питтсбург,0,3,0,0,1,4,2,1,0,0,0,3
2018-10-14,Вашингтон,Торонто,1,1,0,0,0,2,0,2,2,0,0,4
2018-10-14,Флорида,Ванкувер,0,2,0,0,0,2,0,2,1,0,0,3
2018-10-14,Нэшвилл,Айлендерс,3,0,2,0,0,5,0,2,0,0,0,2
2018-10-14,Даллас,Анахайм,0,4,1,0,0,5,2,1,0,0,0,3
2018-10-14,Чикаго,Сент-Луис,2,0,1,1,0,4,0,1,2,0,0,3
2018-10-14,Аризона,Баффало,0,0,0,0,0,0,2,0,1,0,0,3
2018-10-14,Колорадо,Калгари,2,0,0,0,0,2,0,1,1,1,0,3
2018-10-14,Нью-Джерси,Сан-Хосе,0,1,2,0,0,3,0,2,0,0,0,2
2018-10-15,Виннипег,Каролина,0,0,3,0,0,3,0,0,1,0,0,1
2018-10-15,Сент-Луис,Анахайм,0,2,0,0,0,2,1,0,2,0,0,3
2018-10-16,Оттава,Даллас,0,1,3,0,0,4,1,0,0,0,0,1
2018-10-16,Торонто,Лос-Анджелес,2,1,1,0,0,4,0,1,0,0,0,1
2018-10-16,Монреаль,Детройт,3,3,1,0,0,7,1,0,2,0,0,3
2018-10-16,Нэшвилл,Миннесота,1,2,1,0,0,4,1,1,0,0,0,2
2018-10-17,Нью-Джерси,Даллас,1,2,0,0,0,3,0,0,0,0,0,0
2018-10-17,Питтсбург,Ванкувер,1,0,1,0,0,2,2,0,0,1,0,3
2018-10-17,Рейнджерс,Колорадо,1,1,0,0,1,3,0,2,0,0,0,2
2018-10-17,Филадельфия,Флорида,0,5,0,0,1,6,1,2,2,0,0,5
2018-10-17,Тампа-Бэй,Каролина,1,1,2,0,0,4,1,1,0,0,0,2
2018-10-17,Миннесота,Аризона,0,1,1,0,0,2,1,0,0,0,0,1
2018-10-17,Виннипег,Эдмонтон,3,1,0,0,0,4,1,0,3,1,0,5
2018-10-17,Вегас,Баффало,1,1,2,0,0,4,0,0,1,0,0,1
2018-10-18,Вашингтон,Рейнджерс,1,2,0,1,0,4,1,1,1,0,0,3
2018-10-18,Монреаль,Сент-Луис,1,1,1,0,0,3,0,1,1,0,0,2
2018-10-18,Калгари,Бостон,3,1,1,0,0,5,0,2,0,0,0,2
2018-10-18,Анахайм,Айлендерс,1,1,2,0,0,4,0,0,1,0,0,1
2018-10-19,Торонто,Питтсбург,0,0,0,0,0,0,1,0,2,0,0,3
2018-10-19,Нью-Джерси,Колорадо,1,1,1,0,0,3,0,2,3,0,0,5
2018-10-19,Коламбус,Филадельфия,1,3,2,0,0,6,2,0,1,0,0,3
2018-10-19,Тампа-Бэй,Детройт,1,1,1,0,0,3,0,1,0,0,0,1
2018-10-19,Виннипег,Ванкувер,1,0,3,0,0,4,0,1,0,0,0,1
2018-10-19,Чикаго,Аризона,0,1,0,0,0,1,1,1,2,0,0,4
2018-10-19,Эдмонтон,Бостон,0,1,1,1,0,3,0,1,1,0,0,2
2018-10-19,Лос-Анджелес,Айлендерс,1,0,1,0,0,2,1,2,4,0,0,7
2018-10-19,Сан-Хосе,Баффало,2,0,3,0,0,5,0,1,0,0,0,1
2018-10-20,Вашингтон,Флорида,1,3,1,0,0,5,4,1,0,0,1,6
2018-10-20,Даллас,Миннесота,0,0,1,0,0,1,0,0,3,0,0,3
2018-10-20,Калгари,Нэшвилл,1,1,1,0,0,3,1,2,2,0,0,5
2018-10-20,Филадельфия,Нью-Джерси,1,1,3,0,0,5,1,0,1,0,0,2
2018-10-20,Каролина,Колорадо,0,0,1,0,0,1,1,1,1,0,0,3
2018-10-20,Лос-Анджелес,Баффало,0,0,1,0,0,1,1,3,1,0,0,5
2018-10-20,Виннипег,Аризона,1,2,2,0,0,5,1,0,2,0,0,3
2018-10-21,Торонто,Сент-Луис,0,0,1,0,0,1,0,3,1,0,0,4
2018-10-21,Оттава,Монреаль,1,2,0,1,0,4,3,0,0,0,0,3
2018-10-21,Флорида,Детройт,2,0,1,0,0,3,0,3,0,1,0,4
2018-10-21,Коламбус,Чикаго,1,0,0,0,0,1,1,0,3,0,0,4
2018-10-21,Миннесота,Тампа-Бэй,1,1,2,1,0,5,3,0,1,0,0,4
2018-10-21,Эдмонтон,Нэшвилл,0,0,0,0,0,0,0,2,1,0,0,3
2018-10-21,Вегас,Анахайм,1,1,1,0,0,3,0,0,1,0,0,1
2018-10-21,Ванкувер,Бостон,1,0,0,1,0,2,0,0,1,0,0,1
2018-10-21,Сан-Хосе,Айлендерс,1,2,1,0,0,4,1,0,0,0,0,1
2018-10-22,Рейнджерс,Калгари,0,0,1,0,0,1,1,2,1,0,0,4
2018-10-22,Чикаго,Тампа-Бэй,1,0,2,0,0,3,1,3,2,0,0,6
2018-10-22,Анахайм,Баффало,1,1,0,0,0,2,0,2,2,0,0,4
2018-10-23,Филадельфия,Колорадо,0,0,1,0,0,1,1,1,2,0,0,4
2018-10-23,Детройт,Каролина,0,0,1,0,0,1,1,1,1,0,0,3
2018-10-23,Виннипег,Сент-Луис,1,0,3,1,0,5,2,1,1,0,0,4
2018-10-23,Ванкувер,Вашингтон,0,1,1,0,0,2,1,2,2,0,0,5
2018-10-24,Коламбус,Аризона,1,0,0,0,0,1,2,1,1,0,0,4
2018-10-24,Рейнджерс,Флорида,0,3,2,0,0,5,1,0,1,0,0,2
2018-10-24,Монреаль,Калгари,0,3,0,0,0,3,1,0,1,0,0,2
2018-10-24,Оттава,Бостон,0,1,0,0,0,1,1,1,2,0,0,4
2018-10-24,Нэшвилл,Сан-Хосе,1,3,0,0,0,4,1,1,3,0,0,5
2018-10-24,Чикаго,Анахайм,1,0,2,0,0,3,0,1,0,0,0,1
2018-10-24,Даллас,Лос-Анджелес,1,2,1,0,0,4,0,2,0,0,0,2
2018-10-24,Эдмонтон,Питтсбург,0,3,2,0,0,5,1,3,1,1,0,6
2018-10-25,Виннипег,Торонто,0,0,2,0,0,2,1,2,1,0,0,4
2018-10-25,Айлендерс,Флорида,1,1,0,0,0,2,0,0,2,1,0,3
2018-10-25,Колорадо,Тампа-Бэй,0,0,0,0,0,0,0,0,1,0,0,1
2018-10-25,Вегас,Ванкувер,0,2,0,0,0,2,0,2,0,0,1,3
2018-10-26,Бостон,Филадельфия,0,2,1,0,0,3,0,0,0,0,0,0
2018-10-26,Баффало,Монреаль,0,2,2,0,0,4,1,1,1,0,0,3
2018-10-26,Нью-Джерси,Нэшвилл,2,1,0,0,0,3,1,1,1,1,0,4
2018-10-26,Миннесота,Лос-Анджелес,1,1,2,0,0,4,0,0,1,0,0,1
2018-10-26,Сент-Луис,Коламбус,2,1,1,0,0,4,1,3,3,0,0,7
2018-10-26,Чикаго,Рейнджерс,1,1,2,0,0,4,1,0,0,0,0,1
2018-10-26,Даллас,Анахайм,2,3,0,0,0,5,1,1,0,0,0,2
2018-10-26,Эдмонтон,Вашингтон,1,1,2,0,0,4,0,1,0,0,0,1
2018-10-26,Калгари,Питтсбург,0,0,1,0,0,1,3,4,2,0,0,9
2018-10-26,Аризона,Ванкувер,0,1,3,0,0,4,0,1,0,0,0,1
2018-10-27,Вегас,Тампа-Бэй,1,0,1,0,0,2,2,1,0,0,0,3
2018-10-27,Детройт,Виннипег,1,0,0,0,0,1,0,1,1,0,0,2
2018-10-27,Каролина,Сан-Хосе,0,3,0,0,1,4,2,1,0,0,0,3
2018-10-27,Колорадо,Оттава,0,2,4,0,0,6,2,1,0,0,0,3
2018-10-27,Нью-Джерси,Флорида,1,2,0,0,0,3,0,0,2,0,0,2
2018-10-27,Филадельфия,Айлендерс,0,1,0,0,0,1,2,1,3,0,0,6
2018-10-27,Нэшвилл,Эдмонтон,0,1,2,0,0,3,1,2,2,0,0,5
2018-10-27,Калгари,Вашингтон,2,0,1,0,0,3,2,1,0,0,1,4
2018-10-28,Торонто,Виннипег,0,0,3,0,0,3,1,1,0,0,0,2
2018-10-28,Коламбус,Баффало,1,3,0,1,0,5,2,0,2,0,0,4
2018-10-28,Бостон,Монреаль,0,0,0,0,0,0,2,0,1,0,0,3
2018-10-28,Миннесота,Колорадо,0,1,2,0,0,3,1,0,1,0,0,2
2018-10-28,Сент-Луис,Чикаго,2,2,3,0,0,7,2,1,0,0,0,3
2018-10-28,Аризона,Тампа-Бэй,3,2,2,0,0,7,0,0,1,0,0,1
2018-10-28,Ванкувер,Питтсбург,0,0,0,0,0,0,0,2,3,0,0,5
2018-10-28,Лос-Анджелес,Рейнджерс,0,2,2,0,0,4,1,1,1,0,0,3
2018-10-29,Каролина,Айлендерс,0,1,0,0,0,1,1,1,0,0,0,2
2018-10-29,Детройт,Даллас,0,1,3,0,0,4,1,0,1,0,0,2
2018-10-29,Чикаго,Эдмонтон,1,0,0,0,0,1,1,0,0,1,0,2
2018-10-29,Анахайм,Сан-Хосе,1,1,1,0,0,3,1,2,0,1,0,4
2018-10-29,Вегас,Оттава,0,2,1,1,0,4,1,1,1,0,0,3
2018-10-30,Торонто,Калгари,0,0,1,0,0,1,0,0,3,0,0,3
2018-10-30,Ванкувер,Миннесота,1,2,2,0,0,5,1,1,0,0,0,2
2018-10-31,Баффало,Калгари,1,0,0,0,0,1,0,0,1,1,0,2
2018-10-31,Питтсбург,Айлендерс,2,0,1,0,0,3,2,3,1,0,0,6
2018-10-31,Каролина,Бостон,1,1,0,0,0,2,0,2,1,0,0,3
2018-10-31,Коламбус,Детройт,0,0,3,0,0,3,3,0,2,0,0,5
2018-10-31,Тампа-Бэй,Нью-Джерси,2,3,3,0,0,8,2,1,0,0,0,3
2018-10-31,Монреаль,Даллас,0,0,1,0,0,1,0,2,2,0,0,4
2018-10-31,Нэшвилл,Вегас,0,2,2,0,0,4,1,0,0,0,0,1
2018-10-31,Эдмонтон,Миннесота,1,2,0,0,0,3,1,2,1,0,0,4
2018-10-31,Аризона,Оттава,3,1,1,0,0,5,0,1,0,0,0,1
2018-10-31,Анахайм,Филадельфия,0,1,1,0,0,2,1,1,1,0,0,3
2018-10-31,Сан-Хосе,Рейнджерс,1,0,2,0,0,3,1,0,2,0,1,4
2018-11-01,Ванкувер,Чикаго,1,1,2,0,0,4,1,1,0,0,0,2
2018-11-01,Флорида,Виннипег,0,2,0,0,0,2,1,1,2,0,0,4
2018-11-02,Айлендерс,Питтсбург,0,1,1,0,1,3,1,0,1,0,0,2
2018-11-02,Торонто,Даллас,0,0,1,0,0,1,0,1,1,0,0,2
2018-11-02,Тампа-Бэй,Нэшвилл,0,1,0,0,0,1,2,0,2,0,0,4
2018-11-02,Детройт,Нью-Джерси,1,0,3,0,0,4,0,1,2,0,0,3
2018-11-02,Оттава,Баффало,1,2,1,0,0,4,0,0,2,0,0,2
2018-11-02,Монреаль,Вашингтон,1,2,3,0,0,6,1,3,0,0,0,4
2018-11-02,Сент-Луис,Вегас,1,3,1,0,0,5,1,1,1,0,0,3
2018-11-02,Эдмонтон,Чикаго,0,2,2,0,0,4,0,0,0,0,0,0
2018-11-02,Калгари,Колорадо,0,1,5,0,0,6,0,4,1,0,0,5
2018-11-02,Анахайм,Рейнджерс,0,1,1,0,0,2,0,2,0,0,1,3
2018-11-02,Лос-Анджелес,Филадельфия,0,2,0,0,0,2,1,2,2,0,0,5
2018-11-02,Сан-Хосе,Коламбус,1,0,0,0,0,1,1,2,1,0,0,4
2018-11-02,Виннипег,Флорида,2,0,0,0,0,2,1,2,1,0,0,4
2018-11-03,Ванкувер,Колорадо,1,3,2,1,0,7,0,4,2,0,0,6
2018-11-03,Аризона,Каролина,3,0,0,1,0,4,0,1,2,0,0,3
2018-11-03,Баффало,Оттава,3,4,2,0,0,9,0,1,1,0,0,2
2018-11-04,Питтсбург,Торонто,0,0,0,0,0,0,1,2,2,0,0,5
2018-11-04,Вашингтон,Даллас,0,2,1,0,0,3,2,1,0,1,0,4
2018-11-04,Детройт,Эдмонтон,1,1,1,0,0,3,1,2,1,0,0,4
2018-11-04,Монреаль,Тампа-Бэй,1,0,0,0,0,1,2,0,2,0,0,4
2018-11-04,Айлендерс,Нью-Джерси,1,0,2,0,0,3,0,0,0,0,0,0
2018-11-04,Нэшвилл,Бостон,1,0,0,0,0,1,0,0,0,0,0,0
2018-11-04,Сент-Луис,Миннесота,1,0,0,0,0,1,3,1,1,0,0,5
2018-11-04,Калгари,Чикаго,1,1,3,0,0,5,2,1,0,0,0,3
2018-11-04,Вегас,Каролина,1,1,1,0,0,3,0,0,0,0,0,0
2018-11-04,Сан-Хосе,Филадельфия,1,1,1,1,0,4,2,1,0,0,0,3
2018-11-04,Лос-Анджелес,Коламбус,1,1,2,0,0,4,0,0,1,0,0,1
2018-11-05,Оттава,Тампа-Бэй,2,0,1,0,0,3,0,1,2,1,0,4
2018-11-05,Рейнджерс,Баффало,0,2,1,0,0,3,0,0,1,0,0,1
2018-11-05,Анахайм,Коламбус,0,2,0,1,0,3,0,1,1,0,0,2
2018-11-06,Питтсбург,Нью-Джерси,1,0,0,0,0,1,2,2,1,0,0,5
2018-11-06,Бостон,Даллас,1,0,0,1,0,2,1,0,0,0,0,1
2018-11-06,Вашингтон,Эдмонтон,2,2,0,0,0,4,1,1,0,0,0,2
2018-11-06,Айлендерс,Монреаль,3,0,0,0,0,3,1,1,1,0,1,4
2018-11-06,Аризона,Филадельфия,0,1,1,0,0,2,2,1,2,0,0,5
2018-11-07,Торонто,Вегас,1,1,1,0,0,3,0,1,0,0,0,1
2018-11-07,Рейнджерс,Монреаль,1,1,3,0,0,5,1,2,0,0,0,3
2018-11-07,Коламбус,Даллас,1,2,1,0,0,4,0,0,1,0,0,1
2018-11-07,Детройт,Ванкувер,0,1,1,0,1,3,1,1,0,0,0,2
2018-11-07,Оттава,Нью-Джерси,2,3,2,0,0,7,2,0,1,0,0,3
2018-11-07,Тампа-Бэй,Эдмонтон,2,2,1,0,0,5,0,1,1,0,0,2
2018-11-07,Сент-Луис,Каролина,3,0,1,0,0,4,1,0,0,0,0,1
2018-11-07,Лос-Анджелес,Анахайм,2,1,1,0,0,4,0,1,0,0,0,1
2018-11-07,Сан-Хосе,Миннесота,1,2,1,0,0,4,0,1,2,0,0,3
2018-11-08,Вашингтон,Питтсбург,0,1,1,0,0,2,1,0,0,0,0,1
2018-11-08,Колорадо,Нэшвилл,0,1,0,0,0,1,2,1,1,0,0,4
2018-11-08,Анахайм,Калгари,2,0,1,0,0,3,1,0,1,0,0,2
2018-11-09,Филадельфия,Аризона,2,0,2,1,0,5,1,3,0,0,0,4
2018-11-09,Флорида,Эдмонтон,0,2,2,0,0,4,0,0,1,0,0,1
2018-11-09,Бостон,Ванкувер,1,3,1,0,0,5,1,5,2,0,0,8
2018-11-09,Тампа-Бэй,Айлендерс,0,2,2,0,0,4,1,0,1,0,0,2
2018-11-09,Оттава,Вегас,0,1,2,0,0,3,2,1,2,0,0,5
2018-11-09,Монреаль,Баффало,3,2,0,0,0,5,3,1,1,1,0,6
2018-11-09,Чикаго,Каролина,0,2,1,0,0,3,3,1,0,0,0,4
2018-11-09,Даллас,Сан-Хосе,1,2,1,0,0,4,1,1,1,0,0,3
2018-11-09,Лос-Анджелес,Миннесота,1,0,0,0,0,1,1,1,1,0,0,3
2018-11-10,Вашингтон,Коламбус,0,1,0,0,0,1,1,0,1,0,0,2
2018-11-10,Торонто,Нью-Джерси,1,4,1,0,0,6,0,1,0,0,0,1
2018-11-10,Детройт,Рейнджерс,0,0,2,1,0,3,0,2,0,0,0,2
2018-11-10,Виннипег,Колорадо,2,0,3,0,0,5,0,0,2,0,0,2
2018-11-10,Сент-Луис,Сан-Хосе,1,2,1,0,0,4,0,0,0,0,0,0
2018-11-10,Анахайм,Миннесота,0,1,0,0,0,1,1,2,2,0,0,5
2018-11-10,Филадельфия,Чикаго,1,1,2,0,0,4,0,0,0,0,0,0
2018-11-10,Баффало,Ванкувер,1,0,2,0,1,4,0,2,1,0,0,3
2018-11-10,Даллас,Нэшвилл,1,2,1,0,0,4,0,1,3,1,0,5
2018-11-11,Коламбус,Рейнджерс,1,3,0,0,0,4,1,3,0,0,1,5
2018-11-11,Монреаль,Вегас,0,3,2,0,0,5,2,1,1,0,0,4
2018-11-11,Питтсбург,Аризона,0,3,1,0,0,4,0,0,0,0,0,0
2018-11-11,Бостон,Торонто,1,2,2,0,0,5,0,1,0,0,0,1
2018-11-11,Флорида,Айлендерс,1,1,2,0,0,4,1,1,0,0,0,2
2018-11-11,Каролина,Детройт,1,2,0,0,0,3,1,0,2,0,1,4
2018-11-11,Тампа-Бэй,Оттава,1,3,0,0,0,4,2,0,4,0,0,6
2018-11-11,Лос-Анджелес,Калгари,0,0,0,0,0,0,1,0,0,0,0,1
2018-11-11,Сент-Луис,Миннесота,1,1,0,0,0,2,0,2,1,0,0,3
2018-11-12,Вашингтон,Аризона,0,1,0,0,0,1,1,2,1,0,0,4
2018-11-12,Флорида,Оттава,0,5,0,0,0,5,1,0,0,0,0,1
2018-11-12,Виннипег,Нью-Джерси,2,3,0,0,0,5,1,1,0,0,0,2
2018-11-12,Бостон,Вегас,2,1,1,0,0,4,0,1,0,0,0,1
2018-11-12,Сан-Хосе,Калгари,1,1,1,0,0,3,0,1,0,0,0,1
2018-11-12,Эдмонтон,Колорадо,0,0,1,0,0,1,2,2,0,0,0,4
2018-11-13,Каролина,Чикаго,0,2,0,1,0,3,1,1,0,0,0,2
2018-11-13,Рейнджерс,Ванкувер,0,1,1,0,0,2,0,1,0,0,0,1
2018-11-13,Даллас,Коламбус,0,1,0,0,0,1,0,1,1,0,0,2
2018-11-13,Анахайм,Нэшвилл,0,1,0,0,1,2,0,0,1,0,0,1
2018-11-14,Айлендерс,Ванкувер,3,0,2,0,0,5,1,1,0,0,0,2
2018-11-14,Филадельфия,Флорида,0,0,1,0,0,1,0,2,0,0,0,2
2018-11-14,Нью-Джерси,Питтсбург,1,1,2,0,0,4,1,0,1,0,0,2
2018-11-14,Детройт,Аризона,3,1,2,0,0,6,0,0,1,0,0,1
2018-11-14,Баффало,Тампа-Бэй,1,1,0,0,0,2,0,1,0,0,0,1
2018-11-14,Миннесота,Вашингтон,0,1,1,0,0,2,2,1,2,0,0,5
2018-11-14,Эдмонтон,Монреаль,2,1,3,0,0,6,1,1,0,0,0,2
2018-11-14,Лос-Анджелес,Торонто,1,0,0,0,0,1,2,3,0,0,0,5
2018-11-14,Сан-Хосе,Нэшвилл,3,0,2,0,0,5,0,3,1,0,0,4
2018-11-15,Чикаго,Сент-Луис,0,1,0,0,0,1,0,0,0,0,0,0
2018-11-15,Виннипег,Вашингтон,0,1,2,0,0,3,1,0,0,0,0,1
2018-11-15,Колорадо,Бостон,1,1,4,0,0,6,2,1,0,0,0,3
2018-11-15,Вегас,Анахайм,1,3,1,0,0,5,0,0,0,0,0,0
2018-11-16,Коламбус,Флорида,0,3,4,0,0,7,2,1,0,0,0,3
2018-11-16,Питтсбург,Тампа-Бэй,2,1,0,0,0,3,1,3,0,0,0,4
2018-11-16,Айлендерс,Рейнджерс,2,3,2,0,0,7,2,1,2,0,0,5
2018-11-16,Филадельфия,Нью-Джерси,0,0,0,0,0,0,1,0,2,0,0,3
2018-11-16,Оттава,Детройт,1,1,0,0,0,2,0,1,0,0,0,1
2018-11-16,Миннесота,Ванкувер,2,3,1,0,0,6,0,1,1,0,0,2
2018-11-16,Аризона,Нэшвилл,1,1,0,0,0,2,0,0,1,0,0,1
2018-11-16,Калгари,Монреаль,0,2,0,0,0,2,1,0,2,0,0,3
2018-11-16,Сан-Хосе,Торонто,3,0,0,0,0,3,2,2,1,0,0,5
2018-11-17,Даллас,Бостон,0,0,0,1,0,1,0,0,0,0,0,0
2018-11-17,Виннипег,Баффало,0,1,0,0,0,1,0,0,1,0,1,2
2018-11-17,Чикаго,Лос-Анджелес,0,0,1,0,0,1,0,1,0,0,1,2
2018-11-17,Колорадо,Вашингтон,1,0,1,0,0,2,0,2,0,1,0,3
2018-11-17,Вегас,Сент-Луис,1,0,0,0,0,1,1,3,0,0,0,4
2018-11-17,Анахайм,Торонто,0,1,0,0,0,1,1,0,0,1,0,2
2018-11-17,Нью-Джерси,Детройт,1,1,0,0,0,2,0,1,1,1,0,3
2018-11-17,Филадельфия,Тампа-Бэй,0,1,4,0,0,5,0,3,2,1,0,6
2018-11-18,Миннесота,Баффало,2,0,0,0,0,2,1,0,2,0,0,3
2018-11-18,Ванкувер,Монреаль,0,1,1,0,0,2,0,1,2,0,0,3
2018-11-18,Оттава,Питтсбург,3,2,1,0,0,6,1,0,3,0,0,4
2018-11-18,Рейнджерс,Флорида,2,1,1,0,0,4,2,0,0,0,0,2
2018-11-18,Каролина,Коламбус,0,1,0,0,0,1,1,3,0,0,0,4
2018-11-18,Нэшвилл,Лос-Анджелес,0,2,3,0,0,5,0,3,0,0,0,3
2018-11-18,Аризона,Бостон,0,1,0,0,0,1,2,0,0,0,0,2
2018-11-18,Калгари,Эдмонтон,0,1,3,0,0,4,1,1,0,0,0,2
2018-11-18,Сан-Хосе,Сент-Луис,0,3,1,0,0,4,0,0,0,0,0,0
2018-11-18,Айлендерс,Даллас,1,0,1,0,0,2,0,4,2,0,0,6
2018-11-19,Каролина,Нью-Джерси,2,0,0,0,0,2,1,0,0,0,0,1
2018-11-19,Чикаго,Миннесота,2,0,1,0,0,3,0,1,0,0,0,1
2018-11-19,Эдмонтон,Вегас,2,0,1,0,0,3,1,3,2,0,0,6
2018-11-19,Анахайм,Колорадо,1,2,0,0,0,3,0,2,1,1,0,4
2018-11-20,Торонто,Коламбус,0,2,2,0,0,4,2,0,0,0,0,2
2018-11-20,Рейнджерс,Даллас,0,1,1,0,0,2,0,1,0,0,0,1
2018-11-20,Питтсбург,Баффало,2,2,0,0,0,4,1,2,1,1,0,5
2018-11-20,Оттава,Флорида,1,2,2,0,0,5,4,2,1,0,0,7
2018-11-20,Монреаль,Вашингтон,1,3,0,0,0,4,2,1,1,1,0,5
2018-11-20,Нэшвилл,Тампа-Бэй,1,2,0,0,0,3,1,0,1,0,0,2
2018-11-20,Сент-Луис,Лос-Анджелес,0,0,0,0,0,0,0,1,1,0,0,2
2018-11-20,Калгари,Вегас,5,2,0,0,0,7,0,0,2,0,0,2
2018-11-20,Ванкувер,Виннипег,1,2,0,0,0,3,3,1,2,0,0,6
2018-11-21,Сан-Хосе,Эдмонтон,2,1,0,0,0,3,1,1,1,1,0,4
2018-11-22,Питтсбург,Даллас,3,2,0,0,0,5,0,0,1,0,0,1
2018-11-22,Рейнджерс,Айлендерс,3,1,1,0,0,5,0,0,0,0,0,0
2018-11-22,Нью-Джерси,Монреаль,2,3,0,0,0,5,1,0,1,0,0,2
2018-11-22,Каролина,Торонто,2,0,3,0,0,5,1,0,1,0,0,2
2018-11-22,Вашингтон,Чикаго,2,1,1,0,0,4,0,1,1,0,0,2
2018-11-22,Детройт,Бостон,0,1,1,1,0,3,0,1,1,0,0,2
2018-11-22,Баффало,Филадельфия,4,0,1,0,0,5,0,2,0,0,0,2
2018-11-22,Тампа-Бэй,Флорида,2,2,3,0,0,7,1,1,1,0,0,3
2018-11-22,Миннесота,Оттава,2,2,2,0,0,6,0,1,3,0,0,4
2018-11-22,Нэшвилл,Сент-Луис,1,1,2,0,0,4,1,0,0,0,0,1
2018-11-22,Аризона,Вегас,1,0,1,0,0,2,0,2,0,1,0,3
2018-11-22,Анахайм,Ванкувер,1,1,2,0,0,4,0,1,2,0,0,3
2018-11-22,Калгари,Виннипег,5,0,1,0,0,6,1,1,1,0,0,3
2018-11-22,Лос-Анджелес,Колорадо,1,0,2,0,0,3,2,2,3,0,0,7
2018-11-23,Филадельфия,Рейнджерс,1,0,3,0,0,4,0,0,0,0,0,0
2018-11-24,Баффало,Монреаль,1,0,1,1,0,3,0,1,1,0,0,2
2018-11-24,Вашингтон,Детройт,0,1,2,0,0,3,1,0,0,0,0,1
2018-11-24,Миннесота,Виннипег,0,0,4,0,0,4,1,1,0,0,0,2
2018-11-24,Нью-Джерси,Айлендерс,0,1,2,0,0,3,1,1,1,1,0,4
2018-11-24,Анахайм,Эдмонтон,0,0,1,1,0,2,0,0,1,0,0,1
2018-11-24,Вегас,Калгари,0,1,1,0,0,2,0,0,0,0,0,0
2018-11-24,Коламбус,Торонто,2,1,1,0,0,4,1,1,0,0,0,2
2018-11-24,Тампа-Бэй,Чикаго,4,0,0,0,0,4,1,1,0,0,0,2
2018-11-24,Каролина,Флорида,1,0,3,0,0,4,0,0,1,0,0,1
2018-11-24,Бостон,Питтсбург,0,1,0,1,0,2,0,1,0,0,0,1
2018-11-24,Аризона,Колорадо,0,0,1,0,0,1,3,0,2,0,0,5
2018-11-24,Сент-Луис,Нэшвилл,3,2,1,0,0,6,1,0,1,0,0,2
2018-11-24,Даллас,Оттава,1,2,3,0,0,6,1,1,2,0,0,4
2018-11-24,Сан-Хосе,Ванкувер,2,0,2,0,0,4,0,0,0,0,0,0
2018-11-24,Рейнджерс,Вашингтон,1,1,1,0,0,3,0,3,2,0,0,5
2018-11-25,Торонто,Филадельфия,4,2,0,0,0,6,0,0,0,0,0,0
2018-11-25,Айлендерс,Каролина,2,1,1,0,0,4,0,0,1,0,0,1
2018-11-25,Питтсбург,Коламбус,3,1,0,0,0,4,1,1,0,0,0,2
2018-11-25,Детройт,Баффало,0,1,1,0,0,2,1,0,1,0,1,3
2018-11-25,Монреаль,Бостон,0,0,2,0,0,2,2,0,1,0,0,3
2018-11-25,Сент-Луис,Виннипег,2,0,2,0,0,4,2,4,2,0,0,8
2018-11-25,Флорида,Чикаго,2,2,0,0,0,4,0,2,2,1,0,5
2018-11-25,Колорадо,Даллас,0,1,2,0,0,3,0,0,2,0,0,2
2018-11-25,Лос-Анджелес,Ванкувер,0,2,0,0,0,2,0,2,2,0,0,4
2018-11-25,Вегас,Сан-Хосе,4,1,1,0,0,6,0,0,0,0,0,0
2018-11-25,Аризона,Калгари,0,0,1,0,0,1,2,2,2,0,0,6
2018-11-26,Тампа-Бэй,Нью-Джерси,4,1,0,0,0,5,1,0,1,0,0,2
2018-11-26,Нэшвилл,Анахайм,1,2,2,0,0,5,0,2,0,0,0,2
2018-11-26,Лос-Анджелес,Эдмонтон,1,1,3,0,0,5,1,1,0,0,0,2
2018-11-27,Рейнджерс,Оттава,1,0,3,0,0,4,1,0,1,0,0,2
2018-11-27,Айлендерс,Вашингтон,1,0,0,0,0,1,1,1,2,0,0,4
2018-11-27,Торонто,Бостон,1,2,1,0,0,4,0,2,0,0,0,2
2018-11-27,Флорида,Нью-Джерси,0,2,1,1,0,4,0,2,1,0,0,3
2018-11-27,Детройт,Коламбус,0,3,2,0,0,5,3,2,2,0,0,7
2018-11-28,Баффало,Сан-Хосе,0,1,1,1,0,3,0,0,2,0,0,2
2018-11-28,Филадельфия,Оттава,1,2,0,0,0,3,1,0,3,0,0,4
2018-11-28,Тампа-Бэй,Анахайм,0,1,0,0,0,1,0,1,2,0,0,3
2018-11-28,Монреаль,Каролина,0,0,1,0,0,1,1,1,0,0,0,2
2018-11-28,Виннипег,Питтсбург,1,2,0,0,0,3,1,1,2,0,0,4
2018-11-28,Чикаго,Вегас,0,2,1,0,0,3,3,3,2,0,0,8
2018-11-28,Миннесота,Аризона,1,2,0,0,0,3,1,0,3,0,0,4
2018-11-28,Нэшвилл,Колорадо,1,1,0,0,0,2,1,1,1,0,0,3
2018-11-28,Эдмонтон,Даллас,0,0,0,1,0,1,0,0,0,0,0,0
2018-11-28,Ванкувер,Лос-Анджелес,0,0,1,0,0,1,0,1,0,1,0,2
2018-11-29,Детройт,Сент-Луис,0,3,1,0,0,4,0,2,1,0,0,3
2018-11-29,Флорида,Анахайм,0,2,0,0,0,2,1,1,1,0,0,3
2018-11-29,Торонто,Сан-Хосе,3,1,1,0,0,5,1,1,1,0,0,3
2018-11-29,Калгари,Даллас,1,0,2,0,0,3,1,1,1,1,0,4
2018-11-29,Колорадо,Питтсбург,1,2,3,0,0,6,0,2,1,0,0,3
2018-11-30,Коламбус,Миннесота,1,3,0,0,0,4,1,1,0,0,0,2
2018-11-30,Оттава,Рейнджерс,2,1,0,0,0,3,0,0,0,0,0,0
2018-11-30,Тампа-Бэй,Баффало,3,0,2,0,0,5,2,1,1,0,0,4
2018-11-30,Нэшвилл,Аризона,0,0,0,0,0,0,0,2,1,0,0,3
2018-11-30,Виннипег,Чикаго,2,2,2,0,0,6,2,1,2,0,0,5
2018-11-30,Бостон,Айлендерс,0,1,0,0,1,2,1,0,0,0,0,1
2018-11-30,Эдмонтон,Лос-Анджелес,2,0,1,0,0,3,2,0,0,0,0,2
2018-11-30,Ванкувер,Вегас,1,0,2,0,0,3,1,1,2,0,0,4
2018-12-01,Флорида,Баффало,1,0,1,1,0,3,1,1,0,0,0,2
2018-12-01,Вашингтон,Нью-Джерси,1,1,4,0,0,6,0,1,2,0,0,3
2018-12-01,Каролина,Анахайм,1,0,0,0,0,1,0,0,1,1,0,2
2018-12-01,Колорадо,Сент-Луис,0,1,1,0,0,2,2,0,0,1,0,3
2018-12-01,Калгари,Лос-Анджелес,1,0,3,0,0,4,0,1,0,0,0,1
2018-12-01,Оттава,Сан-Хосе,0,3,3,0,0,6,0,1,1,0,0,2
2018-12-02,Ванкувер,Даллас,1,0,0,0,0,1,0,0,2,0,0,2
2018-12-02,Бостон,Детройт,1,0,1,0,0,2,0,2,2,0,0,4
2018-12-02,Нью-Джерси,Виннипег,1,0,2,0,0,3,0,1,2,1,0,4
2018-12-02,Питтсбург,Филадельфия,1,1,0,0,0,2,1,1,2,0,0,4
2018-12-02,Миннесота,Торонто,1,1,1,0,0,3,2,1,2,0,0,5
2018-12-02,Флорида,Тампа-Бэй,2,2,0,0,0,4,1,2,1,1,0,5
2018-12-02,Айлендерс,Коламбус,0,2,1,0,0,3,0,2,0,0,0,2
2018-12-02,Монреаль,Рейнджерс,2,2,1,0,0,5,0,2,0,0,0,2
2018-12-02,Аризона,Сент-Луис,1,4,1,0,0,6,0,1,0,0,0,1
2018-12-02,Нэшвилл,Чикаго,4,0,1,0,0,5,1,1,0,0,0,2
2018-12-02,Эдмонтон,Вегас,1,0,1,0,0,2,0,1,0,0,0,1
2018-12-02,Вашингтон,Анахайм,3,2,0,0,0,5,1,2,3,0,0,6
2018-12-03,Рейнджерс,Виннипег,1,2,0,0,0,3,0,0,3,0,1,4
2018-12-03,Чикаго,Калгари,1,1,0,0,0,2,1,2,0,0,0,3
2018-12-03,Детройт,Колорадо,0,0,0,0,0,0,0,1,1,0,0,2
2018-12-03,Монреаль,Сан-Хосе,0,1,0,0,0,1,2,1,0,0,0,3
2018-12-03,Лос-Анджелес,Каролина,0,0,2,0,0,2,0,0,0,0,0,0
2018-12-04,Нью-Джерси,Тампа-Бэй,0,1,0,0,0,1,2,2,1,0,0,5
2018-12-04,Нэшвилл,Баффало,1,1,0,0,0,2,0,1,0,0,0,1
2018-12-04,Даллас,Эдмонтон,1,0,3,0,0,4,0,0,1,0,0,1
2018-12-05,Айлендерс,Виннипег,0,0,1,0,0,1,0,0,3,0,0,3
2018-12-05,Флорида,Бостон,0,4,1,0,0,5,0,0,0,0,0,0
2018-12-05,Питтсбург,Колорадо,3,0,3,0,0,6,0,3,0,0,0,3
2018-12-05,Коламбус,Калгари,3,2,1,0,0,6,1,5,3,0,0,9
2018-12-05,Детройт,Тампа-Бэй,2,2,1,0,0,5,0,3,2,0,1,6
2018-12-05,Баффало,Торонто,0,1,2,0,0,3,0,2,1,1,0,4
2018-12-05,Монреаль,Оттава,1,3,1,0,0,5,0,1,1,0,0,2
2018-12-05,Ванкувер,Миннесота,1,1,0,0,0,2,1,2,0,0,0,3
2018-12-05,Вегас,Вашингтон,1,0,4,0,0,5,1,1,1,0,0,3
2018-12-05,Лос-Анджелес,Аризона,0,0,1,0,0,1,1,1,0,0,0,2
2018-12-06,Сент-Луис,Эдмонтон,2,0,0,0,0,2,0,1,1,0,1,3
2018-12-06,Сан-Хосе,Каролина,2,2,1,0,0,5,0,1,0,0,0,1
2018-12-06,Анахайм,Чикаго,2,0,2,0,0,4,0,2,0,0,0,2
2018-12-07,Флорида,Колорадо,1,1,0,0,0,2,1,1,3,0,0,5
2018-12-07,Питтсбург,Айлендерс,2,3,1,0,0,6,1,0,1,0,0,2
2018-12-07,Филадельфия,Коламбус,1,0,2,0,0,3,2,0,1,1,0,4
2018-12-07,Торонто,Детройт,1,0,3,0,0,4,3,1,0,1,0,5
2018-12-07,Оттава,Монреаль,1,1,0,0,0,2,1,2,2,0,0,5
2018-12-07,Тампа-Бэй,Бостон,1,0,2,0,0,3,1,0,1,0,0,2
2018-12-07,Калгари,Миннесота,0,1,1,0,0,2,0,0,0,0,0,0
2018-12-07,Аризона,Вашингтон,1,1,0,0,0,2,0,2,2,0,0,4
2018-12-07,Ванкувер,Нэшвилл,2,2,1,0,0,5,0,1,2,0,0,3
2018-12-07,Вегас,Чикаго,2,0,2,0,0,4,0,2,1,0,0,3
2018-12-07,Лос-Анджелес,Нью-Джерси,1,2,0,0,0,3,1,3,2,0,0,6
2018-12-08,Виннипег,Сент-Луис,0,0,0,0,0,0,0,1,0,0,0,1
2018-12-08,Даллас,Сан-Хосе,0,1,2,0,0,3,1,0,1,0,0,2
2018-12-08,Эдмонтон,Миннесота,3,0,4,0,0,7,1,0,1,0,0,2
2018-12-08,Анахайм,Каролина,1,0,0,0,0,1,0,1,3,0,0,4
2018-12-08,Баффало,Филадельфия,2,0,0,0,0,2,1,1,4,0,0,6
2018-12-09,Лос-Анджелес,Вегас,1,2,2,0,0,5,1,0,0,0,0,1
2018-12-09,Тампа-Бэй,Колорадо,3,3,1,0,0,7,1,0,0,0,0,1
2018-12-09,Бостон,Торонто,1,2,3,0,0,6,0,0,3,0,0,3
2018-12-09,Детройт,Айлендерс,2,0,0,0,0,2,0,2,1,0,0,3
2018-12-09,Коламбус,Вашингтон,0,0,0,0,0,0,3,0,1,0,0,4
2018-12-09,Оттава,Питтсбург,1,0,0,1,0,2,0,1,0,0,0,1
2018-12-09,Флорида,Рейнджерс,0,3,1,0,0,4,2,1,1,0,1,5
2018-12-09,Аризона,Сан-Хосе,0,2,1,0,0,3,2,1,2,0,0,5
2018-12-09,Калгари,Нэшвилл,1,1,3,0,0,5,1,0,1,0,0,2
2018-12-09,Сент-Луис,Ванкувер,0,0,1,0,0,1,3,2,1,0,0,6
2018-12-09,Виннипег,Филадельфия,2,3,2,0,0,7,1,0,0,0,0,1
2018-12-10,Оттава,Бостон,1,0,0,0,0,1,0,1,0,1,0,2
2018-12-10,Чикаго,Монреаль,1,1,0,0,0,2,2,0,1,0,0,3
2018-12-10,Анахайм,Нью-Джерси,3,0,2,0,1,6,3,1,1,0,0,5
2018-12-10,Эдмонтон,Калгари,1,0,0,0,0,1,0,0,0,0,0,0
2018-12-10,Вегас,Даллас,1,2,1,0,0,4,1,0,1,0,0,2
2018-12-11,Айлендерс,Питтсбург,0,1,0,0,0,1,0,0,1,0,1,2
2018-12-11,Тампа-Бэй,Рейнджерс,1,2,3,0,0,6,2,0,1,0,0,3
2018-12-11,Детройт,Лос-Анджелес,1,2,0,0,0,3,0,0,1,0,0,1
2018-12-11,Сан-Хосе,Нью-Джерси,2,2,1,0,0,5,1,1,0,0,0,2
2018-12-12,Коламбус,Ванкувер,1,0,1,0,0,2,0,0,3,0,0,3
2018-12-12,Бостон,Аризона,0,4,0,0,0,4,2,1,0,0,0,3
2018-12-12,Каролина,Торонто,0,1,0,0,0,1,1,1,2,0,0,4
2018-12-12,Баффало,Лос-Анджелес,1,0,2,1,0,4,1,2,0,0,0,3
2018-12-12,Вашингтон,Детройт,3,2,1,0,0,6,0,0,2,0,0,2
2018-12-12,Миннесота,Монреаль,1,4,2,0,0,7,0,0,1,0,0,1
2018-12-12,Виннипег,Чикаго,3,1,2,0,0,6,0,2,1,0,0,3
2018-12-12,Нэшвилл,Оттава,1,1,1,0,0,3,1,0,0,0,0,1
2018-12-12,Сент-Луис,Флорида,0,0,4,0,0,4,1,0,2,0,0,3
2018-12-12,Колорадо,Эдмонтон,0,1,3,0,0,4,1,4,1,0,0,6
2018-12-13,Айлендерс,Вегас,1,1,0,0,0,2,1,1,1,0,0,3
2018-12-13,Чикаго,Питтсбург,2,1,3,0,0,6,1,2,0,0,0,3
2018-12-13,Калгари,Филадельфия,1,2,2,1,0,6,0,4,1,0,0,5
2018-12-13,Анахайм,Даллас,1,1,4,0,0,6,0,3,0,0,0,3
2018-12-14,Коламбус,Лос-Анджелес,2,2,0,0,0,4,1,0,0,0,0,1
2018-12-14,Баффало,Аризона,2,0,1,0,0,3,1,0,0,0,0,1
2018-12-14,Тампа-Бэй,Торонто,1,3,0,0,0,4,1,0,0,0,0,1
2018-12-14,Монреаль,Каролина,0,2,4,0,0,6,0,1,3,0,0,4
2018-12-14,Миннесота,Флорида,1,2,2,0,0,5,1,0,0,0,0,1
2018-12-14,Виннипег,Эдмонтон,2,1,1,1,0,5,1,3,0,0,0,4
2018-12-14,Нэшвилл,Ванкувер,2,1,0,1,0,4,1,0,2,0,0,3
2018-12-14,Сан-Хосе,Даллас,0,1,2,0,0,3,0,1,1,0,0,2
2018-12-15,Рейнджерс,Аризона,2,1,0,0,0,3,0,1,2,1,0,4
2018-12-15,Нью-Джерси,Вегас,0,2,2,1,0,5,3,1,0,0,0,4
2018-12-15,Питтсбург,Бостон,1,2,2,0,0,5,0,1,2,0,0,3
2018-12-15,Детройт,Оттава,1,1,0,0,0,2,2,0,2,0,0,4
2018-12-15,Каролина,Вашингтон,2,2,1,0,0,5,1,3,1,0,1,6
2018-12-15,Сент-Луис,Колорадо,2,0,1,1,0,4,2,0,1,0,0,3
2018-12-15,Чикаго,Виннипег,1,1,1,0,0,3,1,2,0,1,0,4
2018-12-15,Эдмонтон,Филадельфия,1,2,1,0,0,4,0,0,1,0,0,1
2018-12-15,Миннесота,Калгари,0,1,0,0,0,1,1,0,1,0,0,2
2018-12-16,Монреаль,Оттава,1,0,4,0,0,5,1,1,0,0,0,2
2018-12-16,Питтсбург,Лос-Анджелес,2,1,0,1,0,4,0,2,1,0,0,3
2018-12-16,Вашингтон,Баффало,2,1,0,0,1,4,1,2,0,0,0,3
2018-12-16,Айлендерс,Детройт,1,0,2,0,1,4,2,0,1,0,0,3
2018-12-16,Флорида,Торонто,1,1,1,1,0,4,0,0,3,0,0,3
2018-12-16,Коламбус,Анахайм,1,0,0,0,0,1,1,0,0,1,0,2
2018-12-16,Нэшвилл,Нью-Джерси,1,0,0,0,1,2,0,0,1,0,0,1
2018-12-16,Колорадо,Даллас,3,1,2,0,0,6,0,2,2,0,0,4
2018-12-16,Ванкувер,Филадельфия,3,1,1,0,0,5,1,0,0,0,0,1
2018-12-16,Рейнджерс,Вегас,1,1,1,0,0,3,1,2,0,1,0,4
2018-12-16,Каролина,Аризона,0,2,1,0,0,3,0,0,0,0,0,0
2018-12-16,Сент-Луис,Калгари,0,2,0,0,0,2,4,1,2,0,0,7
2018-12-17,Бостон,Баффало,0,1,1,0,0,2,0,1,3,0,0,4
2018-12-17,Виннипег,Тампа-Бэй,1,2,1,1,0,5,1,2,1,0,0,4
2018-12-17,Чикаго,Сан-Хосе,3,0,0,0,0,3,2,3,2,0,0,7
2018-12-17,Ванкувер,Эдмонтон,0,2,2,0,0,4,0,1,1,0,0,2
2018-12-18,Коламбус,Вегас,0,0,1,0,0,1,0,0,0,0,0,0
2018-12-18,Питтсбург,Анахайм,2,0,0,0,0,2,0,3,1,0,0,4
2018-12-18,Оттава,Нэшвилл,3,0,0,1,0,4,0,1,2,0,0,3
2018-12-18,Монреаль,Бостон,0,0,0,0,0,0,1,1,2,0,0,4
2018-12-18,Колорадо,Айлендерс,0,1,0,0,0,1,1,2,1,0,0,4
2018-12-19,Баффало,Флорида,1,1,0,0,0,2,0,1,4,0,0,5
2018-12-19,Рейнджерс,Анахайм,0,0,3,0,0,3,0,1,0,0,0,1
2018-12-19,Нью-Джерси,Торонто,1,0,1,0,0,2,3,2,2,0,0,7
2018-12-19,Филадельфия,Детройт,1,2,0,0,0,3,0,1,1,0,0,2
2018-12-19,Миннесота,Сан-Хосе,0,0,0,0,0,0,0,2,2,0,0,4
2018-12-19,Чикаго,Нэшвилл,0,2,0,0,0,2,1,0,0,0,0,1
2018-12-19,Даллас,Калгари,1,1,0,0,0,2,0,0,0,0,0,0
2018-12-19,Аризона,Айлендерс,1,0,0,0,0,1,1,2,0,0,0,3
2018-12-19,Эдмонтон,Сент-Луис,0,1,0,0,0,1,1,0,3,0,0,4
2018-12-19,Ванкувер,Тампа-Бэй,1,0,1,0,0,2,2,1,2,0,0,5
2018-12-19,Лос-Анджелес,Виннипег,1,2,1,0,0,4,0,1,0,0,0,1
2018-12-20,Вашингтон,Питтсбург,0,1,0,0,0,1,0,2,0,0,0,2
2018-12-20,Колорадо,Монреаль,0,1,1,0,0,2,1,0,0,0,0,1
2018-12-21,Бостон,Анахайм,0,2,1,0,0,3,0,0,1,0,0,1
2018-12-21,Торонто,Флорида,1,2,3,0,0,6,0,0,1,0,0,1
2018-12-21,Филадельфия,Нэшвилл,1,1,0,0,0,2,0,1,0,0,0,1
2018-12-21,Питтсбург,Миннесота,1,0,1,0,0,2,1,0,0,0,0,1
2018-12-21,Каролина,Детройт,0,1,0,0,0,1,1,1,2,0,0,4
2018-12-21,Коламбус,Нью-Джерси,1,1,0,0,0,2,0,1,0,0,0,1
2018-12-21,Даллас,Чикаго,0,1,1,0,0,2,2,1,2,0,0,5
2018-12-21,Калгари,Тампа-Бэй,3,0,1,0,0,4,1,2,1,0,1,5
2018-12-21,Аризона,Монреаль,0,1,0,0,0,1,0,1,1,0,0,2
2018-12-21,Ванкувер,Сент-Луис,0,2,3,0,0,5,0,0,1,0,0,1
2018-12-21,Вегас,Айлендерс,0,1,3,0,0,4,2,0,0,0,0,2
2018-12-21,Сан-Хосе,Виннипег,2,1,0,0,0,3,3,0,2,0,0,5
2018-12-22,Вашингтон,Баффало,0,1,1,0,0,2,0,0,1,0,0,1
2018-12-22,Нью-Джерси,Оттава,2,3,0,0,0,5,0,2,0,0,0,2
2018-12-22,Колорадо,Чикаго,0,1,0,0,0,1,1,0,1,0,0,2
2018-12-22,Филадельфия,Коламбус,1,1,1,0,0,3,1,3,0,0,0,4
2018-12-22,Бостон,Нэшвилл,1,0,4,0,0,5,0,1,1,0,0,2
2018-12-22,Детройт,Флорида,0,1,0,0,0,1,2,0,0,0,0,2
2018-12-23,Сан-Хосе,Лос-Анджелес,0,0,2,0,0,2,1,0,1,1,0,3
2018-12-23,Калгари,Сент-Луис,1,0,0,0,0,1,2,0,1,0,0,3
2018-12-23,Вегас,Монреаль,1,2,0,0,0,3,1,1,1,1,0,4
2018-12-23,Оттава,Вашингтон,0,0,0,0,0,0,2,2,0,0,0,4
2018-12-23,Каролина,Питтсбург,0,0,0,0,0,0,1,2,0,0,0,3
2018-12-23,Торонто,Рейнджерс,1,0,4,0,0,5,0,1,2,0,0,3
2018-12-23,Баффало,Анахайм,1,0,2,0,0,3,0,0,0,0,0,0
2018-12-23,Аризона,Колорадо,2,2,2,0,0,6,1,0,3,0,0,4
2018-12-23,Миннесота,Даллас,0,0,1,0,0,1,0,0,1,1,0,2
2018-12-23,Ванкувер,Виннипег,0,0,0,0,0,0,0,0,1,0,0,1
2018-12-23,Эдмонтон,Тампа-Бэй,1,1,1,0,0,3,1,2,3,0,0,6
2018-12-23,Нью-Джерси,Коламбус,0,0,0,0,0,0,2,1,0,0,0,3
2018-12-24,Каролина,Бостон,1,3,1,0,0,5,2,1,0,0,0,3
2018-12-24,Чикаго,Флорида,1,1,1,0,0,3,1,3,2,0,0,6
2018-12-24,Рейнджерс,Филадельфия,1,0,1,0,0,2,0,1,1,0,1,3
2018-12-24,Торонто,Детройт,1,2,1,1,0,5,2,1,1,0,0,4
2018-12-24,Вегас,Лос-Анджелес,1,1,1,0,0,3,0,2,1,1,0,4
2018-12-24,Даллас,Айлендерс,0,1,0,0,0,1,0,1,2,0,0,3
2018-12-24,Сан-Хосе,Аризона,1,0,2,0,0,3,1,1,1,0,1,4
2018-12-28,Бостон,Нью-Джерси,0,1,1,0,0,2,2,0,3,0,0,5
2018-12-28,Рейнджерс,Коламбус,1,1,1,0,0,3,2,0,1,1,0,4
2018-12-28,Вашингтон,Каролина,0,2,1,0,0,3,0,0,1,0,0,1
2018-12-28,Питтсбург,Детройт,0,3,2,0,0,5,1,0,1,0,0,2
2018-12-28,Тампа-Бэй,Филадельфия,2,3,0,1,0,6,1,1,3,0,0,5
2018-12-28,Виннипег,Калгари,0,1,0,0,0,1,0,2,2,0,0,4
2018-12-28,Нэшвилл,Даллас,0,0,0,0,0,0,1,1,0,0,0,2
2018-12-28,Сент-Луис,Баффало,0,3,1,0,0,4,0,1,0,0,0,1
2018-12-28,Чикаго,Миннесота,1,2,2,0,0,5,1,0,1,0,0,2
2018-12-28,Эдмонтон,Ванкувер,1,1,0,0,0,2,4,0,0,0,0,4
2018-12-28,Вегас,Колорадо,1,0,1,0,0,2,1,0,0,0,0,1
2018-12-28,Сан-Хосе,Анахайм,1,1,2,0,0,4,1,0,1,0,0,2
2018-12-28,Лос-Анджелес,Аризона,1,0,1,0,0,2,1,0,0,0,0,1
2018-12-29,Коламбус,Торонто,1,0,1,0,0,2,2,1,1,0,0,4
2018-12-29,Айлендерс,Оттава,0,2,4,0,0,6,1,2,0,0,0,3
2018-12-29,Флорида,Монреаль,2,0,1,0,0,3,2,0,3,0,0,5
2018-12-29,Нью-Джерси,Каролина,0,1,1,0,0,2,0,0,0,0,0,0
2018-12-30,Виннипег,Миннесота,0,0,1,0,0,1,1,1,1,0,0,3
2018-12-30,Лос-Анджелес,Вегас,1,0,0,0,0,1,1,1,2,0,0,4
2018-12-30,Эдмонтон,Сан-Хосе,1,0,3,0,0,4,2,2,3,0,0,7
2018-12-30,Оттава,Вашингтон,0,1,1,0,0,2,2,1,0,0,0,3
2018-12-30,Флорида,Филадельфия,0,0,2,0,0,2,1,0,0,0,0,1
2018-12-30,Баффало,Бостон,1,1,0,0,0,2,1,0,1,1,0,3
2018-12-30,Торонто,Айлендерс,0,0,0,0,0,0,1,3,0,0,0,4
2018-12-30,Тампа-Бэй,Монреаль,2,2,2,0,0,6,3,2,0,0,0,5
2018-12-30,Сент-Луис,Питтсбург,0,1,0,0,0,1,1,3,2,0,0,6
2018-12-30,Даллас,Детройт,0,3,2,0,0,5,0,0,1,0,0,1
2018-12-30,Нэшвилл,Рейнджерс,1,2,0,0,0,3,1,1,2,0,0,4
2018-12-30,Колорадо,Чикаго,1,1,0,0,0,2,2,0,0,1,0,3
2018-12-30,Анахайм,Аризона,2,2,0,0,0,4,1,3,0,1,0,5
2018-12-30,Калгари,Ванкувер,1,1,0,0,0,2,1,1,0,1,0,3
2018-12-31,Аризона,Вегас,0,1,0,0,0,1,1,1,3,0,0,5
2018-12-31,Вашингтон,Нэшвилл,2,1,0,0,0,3,1,3,2,0,0,6
2018-12-31,Нью-Джерси,Ванкувер,2,0,2,0,0,4,0,0,0,0,0,0
2019-01-01,Баффало,Айлендерс,0,0,1,0,0,1,0,1,2,0,0,3
2019-01-01,Миннесота,Питтсбург,1,0,1,0,0,2,2,1,0,0,0,3
2019-01-01,Каролина,Филадельфия,1,2,0,0,0,3,0,0,1,0,0,1
2019-01-01,Коламбус,Оттава,0,1,5,0,0,6,0,1,2,0,0,3
2019-01-01,Сент-Луис,Рейнджерс,1,0,0,0,0,1,1,1,0,0,0,2
2019-01-01,Детройт,Флорида,3,0,0,0,0,3,0,3,0,0,1,4
2019-01-01,Колорадо,Лос-Анджелес,0,0,2,0,0,2,0,2,0,1,0,3
2019-01-01,Анахайм,Тампа-Бэй,1,0,0,0,0,1,1,0,0,1,0,2
2019-01-01,Даллас,Монреаль,0,2,0,0,0,2,1,0,1,1,0,3
2019-01-01,Эдмонтон,Виннипег,1,1,1,0,0,3,0,3,1,0,0,4
2019-01-01,Калгари,Сан-Хосе,3,2,3,0,0,8,1,2,2,0,0,5
2019-01-01,Чикаго,Бостон,1,1,0,0,0,2,1,1,2,0,0,4
2019-01-02,Нэшвилл,Филадельфия,0,2,2,0,0,4,0,0,0,0,0,0
2019-01-02,Вегас,Лос-Анджелес,0,0,2,0,0,2,0,0,0,0,0,0
2019-01-03,Детройт,Калгари,2,1,0,0,0,3,0,3,2,0,0,5
2019-01-03,Рейнджерс,Питтсбург,0,1,1,0,0,2,0,4,3,0,0,7
2019-01-03,Оттава,Ванкувер,0,1,2,0,0,3,0,2,1,1,0,4
2019-01-03,Даллас,Нью-Джерси,1,3,1,0,0,5,1,3,0,0,0,4
2019-01-03,Аризона,Эдмонтон,1,0,0,0,0,1,0,2,1,0,0,3
2019-01-03,Колорадо,Сан-Хосе,1,1,2,0,0,4,2,3,0,0,0,5
2019-01-03,Торонто,Миннесота,2,1,0,0,0,3,1,2,1,0,0,4
2019-01-04,Филадельфия,Каролина,0,0,3,0,0,3,0,3,2,0,0,5
2019-01-04,Бостон,Калгари,2,1,3,0,0,6,1,1,2,0,0,4
2019-01-04,Баффало,Флорида,2,0,2,0,0,4,0,1,2,0,0,3
2019-01-04,Монреаль,Ванкувер,1,1,0,0,0,2,0,0,0,0,0,0
2019-01-04,Айлендерс,Чикаго,1,1,0,1,0,3,1,0,1,0,0,2
2019-01-04,Сент-Луис,Вашингтон,1,2,2,0,0,5,1,1,0,0,0,2
2019-01-04,Лос-Анджелес,Тампа-Бэй,0,1,1,0,0,2,3,2,1,0,0,6
2019-01-05,Питтсбург,Виннипег,2,1,1,0,0,4,0,0,0,0,0,0
2019-01-05,Каролина,Коламбус,2,1,1,0,0,4,0,2,0,0,0,2
2019-01-05,Детройт,Нэшвилл,0,2,1,1,0,4,1,1,1,0,0,3
2019-01-05,Даллас,Вашингтон,1,0,0,1,0,2,0,1,0,0,0,1
2019-01-05,Аризона,Нью-Джерси,1,1,0,0,0,2,1,1,0,0,1,3
2019-01-05,Колорадо,Рейнджерс,2,1,3,0,0,6,0,0,1,0,0,1
2019-01-05,Анахайм,Вегас,0,2,0,0,0,2,1,2,0,0,0,3
2019-01-05,Оттава,Миннесота,1,1,1,0,0,3,0,3,1,0,0,4
2019-01-05,Филадельфия,Калгари,1,0,1,0,0,2,0,1,1,1,0,3
2019-01-06,Бостон,Баффало,1,1,0,0,0,2,0,0,1,0,0,1
2019-01-06,Торонто,Ванкувер,2,0,3,0,0,5,0,0,0,0,0,0
2019-01-06,Флорида,Коламбус,2,0,1,0,0,3,1,1,1,1,0,4
2019-01-06,Монреаль,Нэшвилл,0,1,0,0,0,1,2,1,1,0,0,4
2019-01-06,Сент-Луис,Айлендерс,2,0,1,0,0,3,0,1,3,0,0,4
2019-01-06,Лос-Анджелес,Эдмонтон,3,0,1,0,0,4,0,0,0,0,0,0
2019-01-06,Сан-Хосе,Тампа-Бэй,2,1,2,0,0,5,1,1,0,0,0,2
2019-01-06,Оттава,Каролина,0,4,0,0,0,4,2,2,1,0,0,5
2019-01-07,Вегас,Нью-Джерси,1,2,0,0,0,3,2,0,0,0,0,2
2019-01-07,Аризона,Рейнджерс,2,3,0,0,0,5,0,0,0,0,0,0
2019-01-07,Виннипег,Даллас,0,2,3,0,0,5,0,1,0,0,0,1
2019-01-07,Детройт,Вашингтон,1,1,0,0,0,2,1,0,2,0,0,3
2019-01-07,Питтсбург,Чикаго,2,1,0,0,0,3,1,2,2,0,0,5
2019-01-07,Анахайм,Эдмонтон,0,0,0,0,0,0,3,1,0,0,0,4
2019-01-08,Торонто,Нэшвилл,0,0,0,0,0,0,0,2,2,0,0,4
2019-01-08,Филадельфия,Сент-Луис,0,0,0,0,0,0,0,1,2,0,0,3
2019-01-08,Монреаль,Миннесота,0,0,0,0,0,0,0,0,1,0,0,1
2019-01-08,Чикаго,Калгари,1,1,1,0,0,3,1,1,2,0,0,4
2019-01-08,Сан-Хосе,Лос-Анджелес,1,1,1,0,0,3,0,1,0,0,0,1
2019-01-09,Айлендерс,Каролина,1,0,2,0,0,3,2,0,2,0,0,4
2019-01-09,Бостон,Миннесота,3,1,0,0,0,4,0,0,0,0,0,0
2019-01-09,Баффало,Нью-Джерси,0,5,0,0,0,5,1,0,0,0,0,1
2019-01-09,Питтсбург,Флорида,2,2,1,0,0,5,0,1,0,0,0,1
2019-01-09,Вашингтон,Филадельфия,1,3,1,0,0,5,1,0,2,0,0,3
2019-01-09,Тампа-Бэй,Коламбус,2,0,2,0,0,4,0,0,0,0,0,0
2019-01-09,Детройт,Монреаль,0,1,1,0,0,2,0,2,1,0,0,3
2019-01-09,Виннипег,Колорадо,2,2,3,0,0,7,1,2,1,0,0,4
2019-01-09,Сент-Луис,Даллас,0,1,0,0,0,1,1,2,0,0,0,3
2019-01-09,Вегас,Рейнджерс,1,2,1,0,0,4,0,0,2,0,0,2
2019-01-09,Сан-Хосе,Эдмонтон,3,2,2,0,0,7,1,1,0,0,0,2
2019-01-10,Чикаго,Нэшвилл,1,1,1,0,0,3,2,1,0,1,0,4
2019-01-10,Калгари,Колорадо,2,1,2,0,0,5,2,0,1,0,0,3
2019-01-10,Анахайм,Оттава,1,0,0,0,0,1,0,0,1,1,0,2
2019-01-11,Нью-Джерси,Торонто,0,2,0,0,0,2,3,0,1,0,0,4
2019-01-11,Филадельфия,Даллас,0,2,0,0,0,2,0,0,1,0,0,1
2019-01-11,Бостон,Вашингтон,0,1,1,0,0,2,1,1,2,0,0,4
2019-01-11,Рейнджерс,Айлендерс,1,1,1,0,0,3,2,1,1,0,0,4
2019-01-11,Коламбус,Нэшвилл,1,0,2,1,0,4,0,0,3,0,0,3
2019-01-11,Тампа-Бэй,Каролина,0,0,3,0,0,3,0,1,0,0,0,1
2019-01-11,Миннесота,Виннипег,1,2,0,0,0,3,0,1,1,0,0,2
2019-01-11,Сент-Луис,Монреаль,2,1,1,0,0,4,0,1,0,0,0,1
2019-01-11,Эдмонтон,Флорида,1,1,1,0,1,4,1,1,1,0,0,3
2019-01-11,Вегас,Сан-Хосе,1,0,1,0,0,2,0,1,2,0,0,3
2019-01-11,Ванкувер,Аризона,0,2,1,0,0,3,0,2,1,1,0,4
2019-01-11,Лос-Анджелес,Оттава,0,1,0,0,0,1,0,2,2,0,0,4
2019-01-12,Каролина,Баффало,1,3,0,0,0,4,1,1,1,0,0,3
2019-01-12,Виннипег,Детройт,2,1,1,0,0,4,0,1,1,0,0,2
2019-01-12,Калгари,Флорида,0,2,2,0,0,4,1,1,1,0,0,3
2019-01-12,Анахайм,Питтсбург,3,1,0,0,0,4,0,3,4,0,0,7
2019-01-12,Айлендерс,Рейнджерс,0,1,0,0,0,1,0,1,1,0,0,2
2019-01-12,Нью-Джерси,Филадельфия,1,1,1,0,0,3,0,1,1,0,0,2
2019-01-13,Монреаль,Колорадо,0,0,3,0,0,3,0,0,0,0,0,0
2019-01-13,Баффало,Тампа-Бэй,2,0,1,0,0,3,1,1,3,0,0,5
2019-01-13,Вашингтон,Коламбус,0,0,1,0,0,1,1,0,0,1,0,2
2019-01-13,Торонто,Бостон,0,2,0,0,0,2,1,2,0,0,0,3
2019-01-13,Миннесота,Детройт,1,1,0,0,0,2,1,2,2,0,0,5
2019-01-13,Чикаго,Вегас,2,1,0,0,0,3,0,2,1,1,0,4
2019-01-13,Даллас,Сент-Луис,0,0,1,0,0,1,2,0,1,0,0,3
2019-01-13,Эдмонтон,Аризона,1,1,0,0,0,2,0,2,1,0,0,3
2019-01-13,Сан-Хосе,Оттава,0,1,3,0,0,4,0,0,1,0,0,1
2019-01-13,Лос-Анджелес,Питтсбург,1,2,2,0,0,5,1,0,1,0,0,2
2019-01-13,Каролина,Нэшвилл,2,3,1,0,0,6,0,2,1,0,0,3
2019-01-14,Виннипег,Анахайм,1,1,1,1,0,4,2,1,0,0,0,3
2019-01-14,Коламбус,Рейнджерс,2,3,2,0,0,7,2,1,2,0,0,5
2019-01-14,Айлендерс,Тампа-Бэй,3,1,1,0,0,5,0,1,0,0,0,1
2019-01-14,Ванкувер,Флорида,0,1,4,0,0,5,0,0,1,0,0,1
2019-01-14,Калгари,Аризона,2,2,3,0,0,7,0,1,0,0,0,1
2019-01-15,Вашингтон,Сент-Луис,1,0,0,0,0,1,0,3,1,0,0,4
2019-01-15,Нью-Джерси,Чикаго,1,5,2,0,0,8,0,3,2,0,0,5
2019-01-15,Торонто,Колорадо,0,2,1,0,0,3,0,3,3,0,0,6
2019-01-15,Филадельфия,Миннесота,2,3,2,0,0,7,2,1,1,0,0,4
2019-01-15,Бостон,Монреаль,1,0,1,0,0,2,1,1,0,1,0,3
2019-01-15,Эдмонтон,Баффало,3,2,2,0,0,7,2,0,0,0,0,2
2019-01-16,Коламбус,Нью-Джерси,3,1,0,0,0,4,0,1,0,0,0,1
2019-01-16,Айлендерс,Сент-Луис,1,0,0,1,0,2,0,0,1,0,0,1
2019-01-16,Рейнджерс,Каролина,3,1,2,0,0,6,1,0,1,0,0,2
2019-01-16,Детройт,Анахайм,0,0,3,0,0,3,0,1,0,0,0,1
2019-01-16,Монреаль,Флорида,0,3,2,0,0,5,1,0,0,0,0,1
2019-01-16,Виннипег,Вегас,0,2,2,0,0,4,0,0,1,0,0,1
2019-01-16,Нэшвилл,Вашингтон,2,4,1,0,0,7,0,1,1,0,0,2
2019-01-16,Миннесота,Лос-Анджелес,0,1,1,0,1,3,0,1,1,0,0,2
2019-01-16,Даллас,Тампа-Бэй,0,0,0,0,0,0,1,0,1,0,0,2
2019-01-16,Сан-Хосе,Питтсбург,2,1,2,0,0,5,1,0,1,0,0,2
2019-01-17,Оттава,Колорадо,0,3,2,0,0,5,0,1,1,0,0,2
2019-01-17,Филадельфия,Бостон,1,2,1,0,0,4,2,0,1,0,0,3
2019-01-17,Калгари,Баффало,1,0,2,0,0,3,0,1,2,1,0,4
2019-01-17,Аризона,Сан-Хосе,2,2,2,0,0,6,1,1,1,0,0,3
2019-01-17,Ванкувер,Эдмонтон,1,1,0,0,0,2,2,0,0,0,1,3
2019-01-18,Рейнджерс,Чикаго,2,1,1,0,0,4,1,0,2,0,0,3
2019-01-18,Айлендерс,Нью-Джерси,3,0,1,0,0,4,0,0,1,0,0,1
2019-01-18,Бостон,Сент-Луис,0,2,3,0,0,5,0,2,0,0,0,2
2019-01-18,Тампа-Бэй,Торонто,1,1,0,0,0,2,1,2,1,0,0,4
2019-01-18,Нэшвилл,Виннипег,0,1,0,0,0,1,1,2,2,0,0,5
2019-01-18,Миннесота,Анахайм,0,0,0,0,0,0,3,0,0,0,0,3
2019-01-18,Даллас,Лос-Анджелес,0,0,1,0,0,1,1,1,0,0,0,2
2019-01-19,Коламбус,Монреаль,0,0,1,0,0,1,1,1,2,0,0,4
2019-01-19,Флорида,Торонто,2,0,1,0,0,3,1,0,0,0,0,1
2019-01-19,Каролина,Оттава,0,1,0,0,0,1,1,3,0,0,0,4
2019-01-19,Вашингтон,Айлендерс,0,0,0,0,0,0,0,0,2,0,0,2
2019-01-19,Аризона,Питтсбург,1,0,1,0,0,2,0,2,0,1,0,3
2019-01-19,Калгари,Детройт,0,2,4,0,0,6,1,1,2,0,0,4
2019-01-19,Ванкувер,Баффало,2,1,1,0,0,4,1,2,0,0,0,3
2019-01-19,Нью-Джерси,Анахайм,1,0,1,0,0,2,2,0,1,0,0,3
2019-01-19,Колорадо,Лос-Анджелес,1,6,0,0,0,7,0,0,1,0,0,1
2019-01-20,Тампа-Бэй,Сан-Хосе,2,2,2,0,0,6,1,1,1,0,0,3
2019-01-20,Сент-Луис,Оттава,1,1,1,0,0,3,1,0,1,0,0,2
2019-01-20,Монреаль,Филадельфия,0,0,2,0,0,2,0,2,3,0,0,5
2019-01-20,Даллас,Виннипег,1,2,1,0,0,4,0,0,2,0,0,2
2019-01-20,Бостон,Рейнджерс,1,0,1,0,0,2,1,1,1,0,0,3
2019-01-20,Нэшвилл,Флорида,0,0,2,0,0,2,2,1,1,0,0,4
2019-01-20,Миннесота,Коламбус,2,0,0,0,0,2,0,1,0,0,0,1
2019-01-20,Вегас,Питтсбург,3,2,2,0,0,7,1,2,0,0,0,3
2019-01-20,Эдмонтон,Калгари,0,1,1,0,0,2,0,3,2,0,0,5
2019-01-20,Чикаго,Вашингтон,3,1,4,0,0,8,1,1,3,0,0,5
2019-01-20,Айлендерс,Анахайм,2,1,0,0,0,3,0,0,0,0,0,0
2019-01-21,Ванкувер,Детройт,1,0,2,0,0,3,0,2,0,0,0,2
2019-01-21,Торонто,Аризона,1,0,1,0,0,2,0,2,2,0,0,4
2019-01-21,Эдмонтон,Каролина,1,1,2,0,0,4,3,3,1,0,0,7
2019-01-21,Колорадо,Нэшвилл,0,1,0,0,0,1,0,3,1,0,0,4
2019-01-22,Лос-Анджелес,Сент-Луис,1,2,1,0,0,4,2,0,1,0,0,3
2019-01-22,Вегас,Миннесота,1,1,0,0,0,2,0,2,2,0,0,4
2019-01-22,Флорида,Сан-Хосе,1,1,4,0,0,6,0,2,0,0,0,2
2019-01-23,Вашингтон,Сан-Хосе,3,2,1,0,0,6,2,2,2,1,0,7
2019-01-23,Оттава,Аризона,0,1,1,0,0,2,1,2,0,0,0,3
2019-01-23,Чикаго,Айлендерс,0,2,0,0,1,3,1,1,0,0,0,2
2019-01-23,Эдмонтон,Детройт,0,0,2,0,0,2,0,2,1,0,0,3
2019-01-23,Калгари,Каролина,1,1,0,1,0,3,1,0,1,0,0,2
2019-01-24,Монреаль,Аризона,1,0,1,0,0,2,0,1,0,0,0,1
2019-01-24,Торонто,Вашингтон,1,2,3,0,0,6,1,1,1,0,0,3
2019-01-24,Колорадо,Миннесота,2,0,0,0,0,2,2,2,1,0,0,5
2019-01-24,Анахайм,Сент-Луис,1,0,0,0,0,1,1,2,2,0,0,5
2019-01-24,Вегас,Нэшвилл,1,0,0,0,0,1,0,2,0,0,0,2
2019-01-24,Ванкувер,Каролина,0,2,0,0,0,2,0,5,0,0,0,5
2019-01-29,Филадельфия,Виннипег,0,2,1,0,0,3,0,1,0,0,0,1
2019-01-29,Питтсбург,Нью-Джерси,0,1,2,0,0,3,2,2,2,0,0,6
2019-01-30,Бостон,Виннипег,2,0,1,0,0,3,1,0,2,0,1,4
2019-01-30,Коламбус,Баффало,1,3,0,0,0,4,3,1,1,0,0,5
2019-01-30,Рейнджерс,Филадельфия,0,0,0,0,0,0,1,0,0,0,0,1
2019-01-31,Питтсбург,Тампа-Бэй,3,1,0,0,0,4,0,0,2,0,0,2
2019-01-31,Даллас,Баффало,1,0,0,0,0,1,0,0,0,0,0,0
2019-02-01,Бостон,Филадельфия,1,1,0,0,0,2,1,0,1,1,0,3
2019-02-01,Нью-Джерси,Рейнджерс,2,0,1,0,0,3,1,1,2,0,0,4
2019-02-01,Виннипег,Коламбус,1,1,2,0,0,4,2,1,0,0,0,3
2019-02-02,Баффало,Чикаго,0,1,2,0,0,3,1,3,3,0,0,7
2019-02-02,Флорида,Нэшвилл,0,1,0,0,0,1,0,0,4,0,0,4
2019-02-02,Питтсбург,Оттава,2,1,2,0,0,5,0,1,2,0,0,3
2019-02-02,Вашингтон,Калгари,2,1,1,0,0,4,1,1,1,0,0,3
2019-02-02,Айлендерс,Тампа-Бэй,0,0,0,0,0,0,0,0,0,0,1,1
2019-02-02,Каролина,Вегас,1,2,2,0,0,5,1,1,0,0,0,2
2019-02-02,Детройт,Торонто,0,1,1,1,0,3,0,1,1,0,0,2
2019-02-02,Даллас,Миннесота,0,1,2,0,0,3,0,1,0,0,0,1
2019-02-02,Филадельфия,Эдмонтон,1,1,2,1,0,5,2,1,1,0,0,4
2019-02-02,Монреаль,Нью-Джерси,1,1,0,0,0,2,1,0,1,1,0,3
2019-02-03,Коламбус,Сент-Луис,0,0,2,0,0,2,2,0,2,0,0,4
2019-02-03,Айлендерс,Лос-Анджелес,1,0,3,0,0,4,1,0,1,0,0,2
2019-02-03,Флорида,Вегас,1,0,2,0,0,3,1,0,0,0,0,1
2019-02-03,Оттава,Детройт,0,0,0,0,0,0,2,0,0,0,0,2
2019-02-03,Виннипег,Анахайм,6,2,1,0,0,9,0,2,1,0,0,3
2019-02-03,Торонто,Питтсбург,1,2,0,0,0,3,2,0,0,0,0,2
2019-02-03,Нэшвилл,Даллас,1,0,0,0,0,1,1,0,2,0,0,3
2019-02-03,Рейнджерс,Тампа-Бэй,0,1,1,0,0,2,1,2,0,0,0,3
2019-02-03,Миннесота,Чикаго,1,0,2,0,0,3,0,2,1,1,0,4
2019-02-03,Колорадо,Ванкувер,0,1,0,0,0,1,2,2,1,0,0,5
2019-02-03,Сан-Хосе,Аризона,0,2,0,1,0,3,0,1,1,0,0,2
2019-02-03,Вашингтон,Бостон,0,0,0,0,0,0,0,1,0,0,0,1
2019-02-03,Каролина,Калгари,1,1,1,0,0,3,1,2,1,0,0,4
2019-02-03,Монреаль,Эдмонтон,1,1,1,1,0,4,1,2,0,0,0,3
2019-02-05,Рейнджерс,Лос-Анджелес,1,1,1,0,0,3,1,0,2,1,0,4
2019-02-05,Торонто,Анахайм,0,3,3,0,0,6,0,0,1,0,0,1
2019-02-05,Филадельфия,Ванкувер,1,1,0,0,0,2,0,1,0,0,0,1
2019-02-05,Даллас,Аризона,0,1,4,0,0,5,1,1,2,0,0,4
2019-02-06,Бостон,Айлендерс,0,1,2,0,0,3,0,1,0,0,0,1
2019-02-06,Питтсбург,Каролина,0,0,0,0,0,0,1,1,2,0,0,4
2019-02-06,Флорида,Сент-Луис,1,0,1,0,0,2,0,0,3,0,0,3
2019-02-06,Нью-Джерси,Лос-Анджелес,0,1,0,0,0,1,1,0,4,0,0,5
2019-02-06,Вашингтон,Ванкувер,1,0,2,0,0,3,0,0,2,0,0,2
2019-02-06,Баффало,Миннесота,1,2,1,0,1,5,0,3,1,0,0,4
2019-02-06,Монреаль,Анахайм,3,0,1,0,0,4,0,1,0,0,0,1
2019-02-06,Тампа-Бэй,Вегас,1,1,0,0,0,2,0,1,1,0,1,3
2019-02-06,Нэшвилл,Аризона,0,3,2,0,0,5,1,0,1,0,0,2
2019-02-06,Виннипег,Сан-Хосе,1,1,0,0,0,2,1,0,1,1,0,3
2019-02-06,Колорадо,Коламбус,2,1,0,0,0,3,2,1,3,0,0,6
2019-02-06,Эдмонтон,Чикаго,2,0,0,0,0,2,1,0,5,0,0,6
2019-02-07,Торонто,Оттава,1,3,1,0,0,5,1,1,2,0,0,4
2019-02-07,Рейнджерс,Бостон,1,0,2,0,1,4,0,3,0,0,0,3
2019-02-08,Вашингтон,Колорадо,1,1,1,1,0,4,0,1,2,0,0,3
2019-02-08,Флорида,Питтсбург,1,1,0,1,0,3,0,1,1,0,0,2
2019-02-08,Нью-Джерси,Айлендерс,1,0,0,0,0,1,1,0,0,0,1,2
2019-02-08,Баффало,Каролина,0,2,3,0,0,5,1,1,3,1,0,6
2019-02-08,Филадельфия,Лос-Анджелес,0,1,1,0,0,2,1,1,0,0,1,3
2019-02-08,Оттава,Анахайм,1,1,2,0,0,4,0,0,0,0,0,0
2019-02-08,Тампа-Бэй,Сент-Луис,0,0,0,0,0,0,0,0,0,1,0,1
2019-02-08,Детройт,Вегас,1,0,2,0,0,3,0,3,1,0,0,4
2019-02-08,Монреаль,Виннипег,1,1,3,0,0,5,1,0,1,0,0,2
2019-02-08,Нэшвилл,Даллас,1,0,1,1,0,3,0,0,2,0,0,2
2019-02-08,Миннесота,Эдмонтон,0,0,1,0,0,1,1,1,2,0,0,4
2019-02-08,Чикаго,Ванкувер,2,1,0,1,0,4,0,2,1,0,0,3
2019-02-08,Калгари,Сан-Хосе,1,1,0,0,0,2,3,1,1,0,0,5
2019-02-08,Аризона,Коламбус,0,2,0,0,0,2,2,1,1,0,0,4
2019-02-09,Рейнджерс,Каролина,0,0,0,0,0,0,0,0,3,0,0,3
2019-02-09,Нью-Джерси,Миннесота,1,0,1,0,0,2,1,2,1,0,0,4
2019-02-09,Баффало,Детройт,0,3,0,0,0,3,0,1,0,0,0,1
2019-02-09,Айлендерс,Колорадо,0,1,2,1,0,4,1,1,1,0,0,3
2019-02-09,Филадельфия,Анахайм,4,0,2,0,0,6,0,1,1,0,0,2
2019-02-09,Бостон,Лос-Анджелес,0,1,3,1,0,5,0,2,2,0,0,4
2019-02-09,Оттава,Виннипег,2,2,1,0,0,5,0,1,1,0,0,2
2019-02-09,Сент-Луис,Нэшвилл,2,1,0,0,0,3,0,1,1,0,0,2
2019-02-10,Аризона,Даллас,1,1,1,0,0,3,0,0,2,0,0,2
2019-02-10,Монреаль,Торонто,1,1,1,0,0,3,2,0,1,1,0,4
2019-02-10,Эдмонтон,Сан-Хосе,0,1,1,0,0,2,2,1,2,0,0,5
2019-02-10,Вашингтон,Флорида,0,2,2,0,0,4,2,1,1,1,0,5
2019-02-10,Тампа-Бэй,Питтсбург,2,1,2,0,0,5,1,2,1,0,0,4
2019-02-10,Вегас,Коламбус,2,0,1,0,0,3,1,1,2,0,0,4
2019-02-10,Ванкувер,Калгари,2,1,0,0,1,4,2,1,0,0,0,3
2019-02-10,Нэшвилл,Сент-Луис,0,1,3,0,0,4,0,3,1,1,0,5
2019-02-10,Баффало,Виннипег,0,1,0,0,0,1,0,1,2,0,0,3
2019-02-10,Нью-Джерси,Каролина,2,0,1,0,0,3,0,1,1,0,0,2
2019-02-10,Чикаго,Детройт,2,0,3,0,0,5,0,1,1,0,0,2
2019-02-10,Айлендерс,Миннесота,1,1,0,0,0,2,0,1,0,0,0,1
2019-02-10,Бостон,Колорадо,0,1,0,1,0,2,1,0,0,0,0,1
2019-02-11,Флорида,Тампа-Бэй,0,2,0,0,0,2,1,2,2,0,0,5
2019-02-11,Рейнджерс,Торонто,2,0,2,0,0,4,1,0,0,0,0,1
2019-02-12,Вашингтон,Лос-Анджелес,2,3,1,0,0,6,2,1,1,0,0,4
2019-02-12,Филадельфия,Питтсбург,0,0,1,0,0,1,1,1,2,0,0,4
2019-02-12,Ванкувер,Сан-Хосе,1,0,1,0,0,2,3,3,1,0,0,7
2019-02-13,Баффало,Айлендерс,1,1,1,0,0,3,1,0,0,0,0,1
2019-02-13,Коламбус,Вашингтон,0,1,2,0,0,3,0,0,0,0,0,0
2019-02-13,Флорида,Даллас,0,0,0,0,0,0,1,1,1,0,0,3
2019-02-13,Бостон,Чикаго,3,1,2,0,0,6,1,1,1,0,0,3
2019-02-13,Оттава,Каролина,1,0,0,0,0,1,0,0,4,0,0,4
2019-02-13,Тампа-Бэй,Калгари,3,2,1,0,0,6,1,1,1,0,0,3
2019-02-13,Сент-Луис,Нью-Джерси,3,3,2,0,0,8,1,0,2,0,0,3
2019-02-13,Нэшвилл,Детройт,0,2,0,0,0,2,1,1,1,0,0,3
2019-02-13,Миннесота,Филадельфия,3,0,1,0,0,4,1,2,2,0,0,5
2019-02-13,Виннипег,Рейнджерс,2,0,2,0,0,4,0,2,1,0,0,3
2019-02-13,Колорадо,Торонто,1,0,1,0,0,2,1,3,1,0,0,5
2019-02-13,Вегас,Аризона,0,2,0,0,0,2,0,2,3,0,0,5
2019-02-14,Питтсбург,Эдмонтон,0,2,1,0,0,3,1,0,0,0,0,1
2019-02-14,Анахайм,Ванкувер,1,0,0,0,0,1,0,0,0,0,0,0
2019-02-15,Коламбус,Айлендерс,0,0,0,0,0,0,1,2,0,0,0,3
2019-02-15,Флорида,Калгари,0,1,1,0,1,3,0,0,2,0,0,2
2019-02-15,Детройт,Оттава,2,1,0,0,0,3,1,1,0,0,0,2
2019-02-15,Тампа-Бэй,Даллас,4,2,0,0,0,6,0,0,0,0,0,0
2019-02-15,Виннипег,Колорадо,1,0,0,0,0,1,2,1,1,0,0,4
2019-02-15,Нэшвилл,Монреаль,0,1,2,0,0,3,0,0,1,0,0,1
2019-02-15,Чикаго,Нью-Джерси,1,2,2,0,0,5,2,0,0,0,0,2
2019-02-15,Аризона,Сент-Луис,0,0,0,0,0,0,2,1,1,0,0,4
2019-02-15,Вегас,Торонто,0,2,1,0,0,3,1,2,3,0,0,6
2019-02-15,Сан-Хосе,Вашингтон,1,0,0,0,0,1,2,2,1,0,0,5
2019-02-15,Лос-Анджелес,Ванкувер,1,1,1,0,0,3,1,1,1,0,1,4
2019-02-16,Баффало,Рейнджерс,0,2,0,0,0,2,2,1,3,0,0,6
2019-02-16,Каролина,Эдмонтон,2,0,1,0,0,3,1,0,0,0,0,1
2019-02-16,Миннесота,Нью-Джерси,2,2,0,0,0,4,0,2,2,1,0,5
2019-02-16,Анахайм,Бостон,0,0,0,0,0,0,1,1,1,0,0,3
2019-02-16,Питтсбург,Калгари,1,1,2,0,0,4,1,4,0,0,0,5
2019-02-16,Филадельфия,Детройт,1,2,2,1,0,6,1,0,4,0,0,5
2019-02-16,Колорадо,Сент-Луис,0,0,0,0,0,0,0,0,3,0,0,3
2019-02-17,Аризона,Торонто,0,2,0,0,0,2,0,0,0,0,0,0
2019-02-17,Айлендерс,Эдмонтон,0,2,3,0,0,5,0,1,1,0,0,2
2019-02-17,Виннипег,Оттава,2,0,1,0,0,3,1,1,1,1,0,4
2019-02-17,Тампа-Бэй,Монреаль,0,0,3,0,0,3,0,0,0,0,0,0
2019-02-17,Каролина,Даллас,2,0,1,0,0,3,0,0,0,0,0,0
2019-02-17,Чикаго,Коламбус,1,1,0,0,0,2,3,0,2,0,0,5
2019-02-17,Сан-Хосе,Ванкувер,1,1,1,0,0,3,1,0,1,0,0,2
2019-02-17,Вегас,Нэшвилл,1,1,3,0,0,5,0,0,1,0,0,1
2019-02-17,Лос-Анджелес,Бостон,0,1,1,0,0,2,1,1,2,0,0,4
2019-02-17,Питтсбург,Рейнджерс,1,2,3,0,0,6,1,2,2,0,0,5
2019-02-17,Миннесота,Сент-Луис,0,0,0,0,0,0,2,2,0,0,0,4
2019-02-18,Нью-Джерси,Баффало,0,2,2,0,0,4,0,1,0,0,0,1
2019-02-18,Детройт,Филадельфия,0,1,0,0,0,1,1,0,2,0,0,3
2019-02-18,Флорида,Монреаль,3,1,2,0,0,6,2,1,0,0,0,3
2019-02-18,Анахайм,Вашингтон,0,2,3,0,0,5,1,1,0,0,0,2
2019-02-19,Калгари,Аризона,1,2,2,0,0,5,0,2,0,0,0,2
2019-02-19,Коламбус,Тампа-Бэй,0,0,1,0,0,1,2,1,2,0,0,5
2019-02-19,Чикаго,Оттава,5,2,1,0,0,8,4,1,2,0,0,7
2019-02-19,Колорадо,Вегас,1,1,1,0,0,3,0,0,0,0,0,0
2019-02-19,Сан-Хосе,Бостон,1,3,1,0,0,5,3,1,1,1,0,6
2019-02-19,Лос-Анджелес,Вашингтон,0,0,2,0,0,2,2,1,0,0,0,3
2019-02-20,Нью-Джерси,Питтсбург,2,0,1,0,0,3,2,2,0,0,0,4
2019-02-20,Филадельфия,Тампа-Бэй,0,0,2,0,0,2,3,0,2,0,0,5
2019-02-20,Каролина,Рейнджерс,0,1,0,0,0,1,0,1,1,0,0,2
2019-02-20,Флорида,Баффало,0,0,4,0,0,4,0,1,1,0,0,2
2019-02-20,Монреаль,Коламбус,2,0,1,0,0,3,0,1,1,0,0,2
2019-02-20,Миннесота,Анахайм,0,0,0,0,0,0,0,1,3,0,0,4
2019-02-20,Сент-Луис,Торонто,2,0,0,1,0,3,0,0,2,0,0,2
2019-02-20,Даллас,Нэшвилл,0,3,0,0,0,3,1,2,2,0,0,5
2019-02-20,Эдмонтон,Аризона,0,0,2,0,0,2,0,1,1,0,1,3
2019-02-21,Детройт,Чикаго,1,0,3,0,0,4,3,1,0,1,0,5
2019-02-21,Колорадо,Виннипег,0,2,5,0,0,7,0,0,1,0,0,1
2019-02-21,Калгари,Айлендерс,2,0,2,0,0,4,0,1,1,0,0,2
2019-02-21,Вегас,Бостон,1,0,1,0,0,2,1,0,1,0,1,3
2019-02-22,Нью-Джерси,Оттава,2,2,0,0,0,4,0,0,0,0,0,0
2019-02-22,Торонто,Вашингтон,0,0,2,0,0,2,0,2,1,0,0,3
2019-02-22,Рейнджерс,Миннесота,0,1,0,0,0,1,1,1,2,0,0,4
2019-02-22,Флорида,Каролина,0,3,0,0,0,3,1,1,2,0,0,4
2019-02-22,Питтсбург,Сан-Хосе,0,0,0,0,0,0,3,0,1,0,0,4
2019-02-22,Монреаль,Филадельфия,3,2,0,0,0,5,0,0,1,0,0,1
2019-02-22,Тампа-Бэй,Баффало,0,1,0,0,1,2,1,0,0,0,0,1
2019-02-22,Нэшвилл,Лос-Анджелес,1,1,0,0,0,2,0,0,1,0,0,1
2019-02-22,Даллас,Сент-Луис,0,4,1,0,0,5,0,2,0,0,0,2
2019-02-22,Эдмонтон,Айлендерс,2,0,1,1,0,4,3,0,0,0,0,3
2019-02-22,Ванкувер,Аризона,1,0,1,0,0,2,0,0,2,1,0,3
2019-02-23,Оттава,Коламбус,0,0,0,0,0,0,1,0,2,0,0,3
2019-02-23,Чикаго,Колорадо,0,2,1,0,0,3,1,1,3,0,0,5
2019-02-23,Детройт,Миннесота,0,1,1,0,0,2,2,1,0,0,0,3
2019-02-23,Калгари,Анахайм,0,1,1,0,0,2,0,1,0,0,0,1
2019-02-23,Вегас,Виннипег,1,1,1,0,0,3,2,2,2,0,0,6
2019-02-23,Баффало,Вашингтон,2,1,2,0,0,5,0,1,1,0,0,2
2019-02-23,Рейнджерс,Нью-Джерси,3,0,2,0,0,5,0,0,2,0,0,2
2019-02-24,Сент-Луис,Бостон,1,0,0,0,1,2,0,1,0,0,0,1
2019-02-24,Флорида,Лос-Анджелес,1,3,2,0,0,6,1,0,0,0,0,1
2019-02-24,Коламбус,Сан-Хосе,1,2,1,0,0,4,0,0,0,0,0,0
2019-02-24,Даллас,Каролина,0,0,0,0,0,0,1,1,1,0,0,3
2019-02-24,Нэшвилл,Колорадо,0,0,0,0,0,0,1,2,2,0,0,5
2019-02-24,Торонто,Монреаль,0,2,4,0,0,6,3,0,0,0,0,3
2019-02-24,Филадельфия,Питтсбург,1,0,2,1,0,4,1,1,1,0,0,3
2019-02-24,Ванкувер,Айлендерс,0,0,0,0,0,0,2,0,2,0,0,4
2019-02-24,Эдмонтон,Анахайм,1,1,0,0,0,2,0,1,0,0,0,1
2019-02-24,Вашингтон,Рейнджерс,2,1,2,1,0,6,1,1,3,0,0,5
2019-02-24,Чикаго,Даллас,0,2,1,0,0,3,2,1,1,0,0,4
2019-02-24,Детройт,Сан-Хосе,2,1,0,0,0,3,1,3,1,0,0,5
2019-02-25,Миннесота,Сент-Луис,0,1,0,1,0,2,0,0,1,0,0,1
2019-02-25,Оттава,Калгари,0,1,0,0,0,1,1,0,1,0,0,2
2019-02-25,Аризона,Виннипег,1,2,1,0,0,4,1,0,0,0,0,1
2019-02-26,Нью-Джерси,Монреаль,1,1,0,0,0,2,0,0,1,0,0,1
2019-02-26,Торонто,Баффало,0,4,1,0,0,5,1,1,1,0,0,3
2019-02-26,Тампа-Бэй,Лос-Анджелес,2,0,1,0,1,4,0,0,3,0,0,3
2019-02-26,Нэшвилл,Эдмонтон,0,2,0,0,1,3,1,0,1,0,0,2
2019-02-26,Колорадо,Флорида,0,2,1,0,0,3,0,2,1,1,0,4
2019-02-26,Ванкувер,Анахайм,2,1,1,0,0,4,0,0,0,0,0,0
2019-02-27,Филадельфия,Баффало,2,1,2,0,0,5,1,1,0,0,0,2
2019-02-27,Бостон,Сан-Хосе,1,3,0,0,0,4,1,0,0,0,0,1
2019-02-27,Коламбус,Питтсбург,0,2,0,0,0,2,2,1,2,0,0,5
2019-02-27,Каролина,Лос-Анджелес,2,4,0,0,0,6,0,0,1,0,0,1
2019-02-27,Вашингтон,Оттава,2,4,1,0,0,7,2,0,0,0,0,2
2019-02-27,Айлендерс,Калгари,0,1,0,0,0,1,0,1,2,0,0,3
2019-02-27,Детройт,Монреаль,0,1,0,0,0,1,1,5,2,0,0,8
2019-02-27,Сент-Луис,Нэшвилл,0,0,2,0,0,2,0,0,0,0,0,0
2019-02-27,Виннипег,Миннесота,1,1,0,0,0,2,0,1,2,0,0,3
2019-02-27,Аризона,Флорида,0,2,1,0,1,4,0,1,2,0,0,3
2019-02-27,Вегас,Даллас,0,1,3,0,0,4,1,0,0,0,0,1
2019-02-28,Торонто,Эдмонтон,1,4,1,0,0,6,1,0,1,0,0,2
2019-02-28,Нью-Джерси,Калгари,0,1,0,0,0,1,0,2,0,0,0,2
2019-02-28,Рейнджерс,Тампа-Бэй,0,3,0,0,0,3,2,1,0,1,0,4
2019-02-28,Колорадо,Ванкувер,2,0,0,0,1,3,1,0,1,0,0,2
2019-02-28,Анахайм,Чикаго,0,2,1,0,0,3,0,2,2,0,0,4
2019-03-01,Айлендерс,Торонто,1,3,2,0,0,6,1,0,0,0,0,1
2019-03-01,Коламбус,Филадельфия,1,1,1,1,0,4,2,0,1,0,0,3
2019-03-01,Бостон,Тампа-Бэй,0,1,3,0,0,4,0,0,1,0,0,1
2019-03-01,Оттава,Эдмонтон,1,0,1,0,0,2,0,2,2,0,0,4
2019-03-01,Аризона,Ванкувер,2,2,1,0,0,5,1,0,1,0,0,2
2019-03-01,Вегас,Флорида,1,3,1,0,1,6,3,1,1,0,0,5
2019-03-01,Лос-Анджелес,Даллас,2,1,0,0,0,3,1,1,1,1,0,4
