DataTime,Hosts,Guests,1PHosts,2PHosts,3PHosts,OTHosts,SSHosts,CountHosts,1PGuests,2PGuests,3PGuests,OTGuests,SSGuests,CountGuests
04.10.2018,Торонто,Монреаль,1,1,0,1,0,3,1,1,0,0,0,2
04.10.2018,Вашингтон,Бостон,2,4,1,0,0,7,0,0,0,0,0,0
04.10.2018,Ванкувер,Калгари,1,0,4,0,0,5,0,0,2,0,0,2
04.10.2018,Сан-Хосе,Анахайм,1,1,0,0,0,2,1,1,3,0,0,5
05.10.2018,Баффало,Бостон,0,0,0,0,0,0,2,1,1,0,0,4
05.10.2018,Питтсбург,Вашингтон,2,3,1,1,0,7,3,1,2,0,0,6
05.10.2018,Каролина,Айлендерс,0,0,1,0,0,1,0,1,0,1,0,2
05.10.2018,Детройт,Коламбус,0,2,0,0,0,2,1,1,0,1,0,3
05.10.2018,Оттава,Чикаго,3,0,0,0,0,3,2,0,1,1,0,4
05.10.2018,Рейнджерс,Нэшвилл,0,1,1,0,0,2,0,1,2,0,0,3
05.10.2018,Сент-Луис,Виннипег,0,0,1,0,0,1,1,0,4,0,0,5
05.10.2018,Даллас,Аризона,0,3,0,0,0,3,0,0,0,0,0,0
05.10.2018,Колорадо,Миннесота,1,1,2,0,0,4,1,0,0,0,0,1
05.10.2018,Вегас,Филадельфия,1,0,1,0,0,2,2,3,0,0,0,5
06.10.2018,Коламбус,Каролина,1,0,0,0,0,1,1,1,1,0,0,3
06.10.2018,Лос-Анджелес,Сан-Хосе,1,1,0,0,0,2,2,0,0,1,0,3
06.10.2018,Нью-Джерси,Эдмонтон,1,2,2,0,0,5,1,0,1,0,0,2
07.10.2018,Даллас,Виннипег,2,1,2,0,0,5,0,1,0,0,0,1
07.10.2018,Тампа-Бэй,Флорида,0,0,1,0,1,2,1,0,0,0,0,1
07.10.2018,Баффало,Рейнджерс,1,1,1,0,0,3,0,0,1,0,0,1
07.10.2018,Айлендерс,Нэшвилл,1,2,0,0,0,3,2,2,0,0,0,4
07.10.2018,Торонто,Оттава,0,3,0,0,0,3,1,2,2,0,0,5
07.10.2018,Питтсбург,Монреаль,0,1,0,0,0,1,2,2,1,0,0,5
07.10.2018,Сент-Луис,Чикаго,2,0,2,0,0,4,1,2,1,1,0,5
07.10.2018,Миннесота,Вегас,1,0,0,0,0,1,0,0,1,0,1,2
07.10.2018,Аризона,Анахайм,0,0,0,0,0,0,0,1,0,0,0,1
07.10.2018,Колорадо,Филадельфия,2,1,2,0,0,5,1,1,0,0,0,2
07.10.2018,Калгари,Ванкувер,2,1,4,0,0,7,2,2,0,0,0,4
08.10.2018,Каролина,Рейнджерс,2,2,4,0,0,8,2,2,1,0,0,5
08.10.2018,Чикаго,Торонто,2,1,3,0,0,6,2,2,2,1,0,7
08.10.2018,Лос-Анджелес,Детройт,0,2,2,0,0,4,0,1,1,0,0,2
08.10.2018,Бостон,Оттава,2,1,3,0,0,6,0,2,1,0,0,3
08.10.2018,Айлендерс,Сан-Хосе,0,1,3,0,0,4,0,0,0,0,0,0
08.10.2018,Баффало,Вегас,1,3,0,0,0,4,0,1,1,0,0,2
09.10.2018,Анахайм,Детройт,0,1,1,0,1,3,1,1,0,0,0,2
10.10.2018,Каролина,Ванкувер,3,1,1,0,0,5,1,2,0,0,0,3
10.10.2018,Филадельфия,Сан-Хосе,0,1,1,0,0,2,4,1,3,0,0,8
10.10.2018,Коламбус,Колорадо,2,0,3,0,0,5,0,2,0,0,0,2
10.10.2018,Виннипег,Лос-Анджелес,1,1,0,0,0,2,1,0,0,0,0,1
10.10.2018,Нэшвилл,Калгари,0,0,0,0,0,0,1,1,1,0,0,3
10.10.2018,Даллас,Торонто,1,2,1,0,0,4,2,3,2,0,0,7
11.10.2018,Оттава,Филадельфия,1,2,1,0,0,4,1,3,3,0,0,7
11.10.2018,Вашингтон,Вегас,1,1,3,0,0,5,0,1,1,0,0,2
11.10.2018,Анахайм,Аризона,1,1,0,0,0,2,1,1,0,0,1,3
12.10.2018,Питтсбург,Вегас,1,3,0,0,0,4,1,0,1,0,0,2
12.10.2018,Рейнджерс,Сан-Хосе,1,0,1,1,0,3,1,1,0,0,0,2
12.10.2018,Флорида,Коламбус,1,3,0,0,0,4,2,1,2,0,0,5
12.10.2018,Нью-Джерси,Вашингтон,2,1,3,0,0,6,0,0,0,0,0,0
12.10.2018,Бостон,Эдмонтон,3,0,1,0,0,4,1,0,0,0,0,1
12.10.2018,Баффало,Колорадо,0,1,0,0,0,1,3,1,2,0,0,6
12.10.2018,Тампа-Бэй,Ванкувер,1,0,0,0,0,1,0,0,4,0,0,4
12.10.2018,Монреаль,Лос-Анджелес,0,0,0,0,0,0,2,0,1,0,0,3
12.10.2018,Детройт,Торонто,1,0,2,0,0,3,1,2,2,0,0,5
12.10.2018,Миннесота,Чикаго,0,2,1,1,0,4,2,0,1,0,0,3
12.10.2018,Нэшвилл,Виннипег,0,1,2,0,0,3,0,0,0,0,0,0
12.10.2018,Сент-Луис,Калгари,3,2,0,0,0,5,1,0,2,0,0,3
13.10.2018,Рейнджерс,Эдмонтон,1,0,0,0,0,1,1,0,1,0,0,2
13.10.2018,Филадельфия,Вегас,0,0,0,0,0,0,0,0,1,0,0,1
13.10.2018,Оттава,Лос-Анджелес,3,1,1,0,0,5,0,1,0,0,0,1
13.10.2018,Бостон,Детройт,1,3,4,0,0,8,0,0,2,0,0,2
14.10.2018,Миннесота,Каролина,1,0,3,0,0,4,1,1,2,1,0,5
14.10.2018,Тампа-Бэй,Коламбус,3,1,4,0,0,8,0,2,0,0,0,2
14.10.2018,Монреаль,Питтсбург,0,3,0,0,1,4,2,1,0,0,0,3
14.10.2018,Вашингтон,Торонто,1,1,0,0,0,2,0,2,2,0,0,4
14.10.2018,Флорида,Ванкувер,0,2,0,0,0,2,0,2,1,0,0,3
14.10.2018,Нэшвилл,Айлендерс,3,0,2,0,0,5,0,2,0,0,0,2
14.10.2018,Даллас,Анахайм,0,4,1,0,0,5,2,1,0,0,0,3
14.10.2018,Чикаго,Сент-Луис,2,0,1,1,0,4,0,1,2,0,0,3
14.10.2018,Аризона,Баффало,0,0,0,0,0,0,2,0,1,0,0,3
14.10.2018,Колорадо,Калгари,2,0,0,0,0,2,0,1,1,1,0,3
14.10.2018,Нью-Джерси,Сан-Хосе,0,1,2,0,0,3,0,2,0,0,0,2
15.10.2018,Виннипег,Каролина,0,0,3,0,0,3,0,0,1,0,0,1
15.10.2018,Сент-Луис,Анахайм,0,2,0,0,0,2,1,0,2,0,0,3
16.10.2018,Оттава,Даллас,0,1,3,0,0,4,1,0,0,0,0,1
16.10.2018,Торонто,Лос-Анджелес,2,1,1,0,0,4,0,1,0,0,0,1
16.10.2018,Монреаль,Детройт,3,3,1,0,0,7,1,0,2,0,0,3
16.10.2018,Нэшвилл,Миннесота,1,2,1,0,0,4,1,1,0,0,0,2
17.10.2018,Нью-Джерси,Даллас,1,2,0,0,0,3,0,0,0,0,0,0
17.10.2018,Питтсбург,Ванкувер,1,0,1,0,0,2,2,0,0,1,0,3
17.10.2018,Рейнджерс,Колорадо,1,1,0,0,1,3,0,2,0,0,0,2
17.10.2018,Филадельфия,Флорида,0,5,0,0,1,6,1,2,2,0,0,5
17.10.2018,Тампа-Бэй,Каролина,1,1,2,0,0,4,1,1,0,0,0,2
17.10.2018,Миннесота,Аризона,0,1,1,0,0,2,1,0,0,0,0,1
17.10.2018,Виннипег,Эдмонтон,3,1,0,0,0,4,1,0,3,1,0,5
17.10.2018,Вегас,Баффало,1,1,2,0,0,4,0,0,1,0,0,1
18.10.2018,Вашингтон,Рейнджерс,1,2,0,1,0,4,1,1,1,0,0,3
18.10.2018,Монреаль,Сент-Луис,1,1,1,0,0,3,0,1,1,0,0,2
18.10.2018,Калгари,Бостон,3,1,1,0,0,5,0,2,0,0,0,2
18.10.2018,Анахайм,Айлендерс,1,1,2,0,0,4,0,0,1,0,0,1
19.10.2018,Торонто,Питтсбург,0,0,0,0,0,0,1,0,2,0,0,3
19.10.2018,Нью-Джерси,Колорадо,1,1,1,0,0,3,0,2,3,0,0,5
19.10.2018,Коламбус,Филадельфия,1,3,2,0,0,6,2,0,1,0,0,3
19.10.2018,Тампа-Бэй,Детройт,1,1,1,0,0,3,0,1,0,0,0,1
19.10.2018,Виннипег,Ванкувер,1,0,3,0,0,4,0,1,0,0,0,1
19.10.2018,Чикаго,Аризона,0,1,0,0,0,1,1,1,2,0,0,4
19.10.2018,Эдмонтон,Бостон,0,1,1,1,0,3,0,1,1,0,0,2
19.10.2018,Лос-Анджелес,Айлендерс,1,0,1,0,0,2,1,2,4,0,0,7
19.10.2018,Сан-Хосе,Баффало,2,0,3,0,0,5,0,1,0,0,0,1
20.10.2018,Вашингтон,Флорида,1,3,1,0,0,5,4,1,0,0,1,6
20.10.2018,Даллас,Миннесота,0,0,1,0,0,1,0,0,3,0,0,3
20.10.2018,Калгари,Нэшвилл,1,1,1,0,0,3,1,2,2,0,0,5
20.10.2018,Филадельфия,Нью-Джерси,1,1,3,0,0,5,1,0,1,0,0,2
20.10.2018,Каролина,Колорадо,0,0,1,0,0,1,1,1,1,0,0,3
20.10.2018,Лос-Анджелес,Баффало,0,0,1,0,0,1,1,3,1,0,0,5
20.10.2018,Виннипег,Аризона,1,2,2,0,0,5,1,0,2,0,0,3
21.10.2018,Торонто,Сент-Луис,0,0,1,0,0,1,0,3,1,0,0,4
21.10.2018,Оттава,Монреаль,1,2,0,1,0,4,3,0,0,0,0,3
21.10.2018,Флорида,Детройт,2,0,1,0,0,3,0,3,0,1,0,4
21.10.2018,Коламбус,Чикаго,1,0,0,0,0,1,1,0,3,0,0,4
21.10.2018,Миннесота,Тампа-Бэй,1,1,2,1,0,5,3,0,1,0,0,4
21.10.2018,Эдмонтон,Нэшвилл,0,0,0,0,0,0,0,2,1,0,0,3
21.10.2018,Вегас,Анахайм,1,1,1,0,0,3,0,0,1,0,0,1
21.10.2018,Ванкувер,Бостон,1,0,0,1,0,2,0,0,1,0,0,1
21.10.2018,Сан-Хосе,Айлендерс,1,2,1,0,0,4,1,0,0,0,0,1
22.10.2018,Рейнджерс,Калгари,0,0,1,0,0,1,1,2,1,0,0,4
22.10.2018,Чикаго,Тампа-Бэй,1,0,2,0,0,3,1,3,2,0,0,6
22.10.2018,Анахайм,Баффало,1,1,0,0,0,2,0,2,2,0,0,4
23.10.2018,Филадельфия,Колорадо,0,0,1,0,0,1,1,1,2,0,0,4
23.10.2018,Детройт,Каролина,0,0,1,0,0,1,1,1,1,0,0,3
23.10.2018,Виннипег,Сент-Луис,1,0,3,1,0,5,2,1,1,0,0,4
23.10.2018,Ванкувер,Вашингтон,0,1,1,0,0,2,1,2,2,0,0,5
24.10.2018,Коламбус,Аризона,1,0,0,0,0,1,2,1,1,0,0,4
24.10.2018,Рейнджерс,Флорида,0,3,2,0,0,5,1,0,1,0,0,2
24.10.2018,Монреаль,Калгари,0,3,0,0,0,3,1,0,1,0,0,2
24.10.2018,Оттава,Бостон,0,1,0,0,0,1,1,1,2,0,0,4
24.10.2018,Нэшвилл,Сан-Хосе,1,3,0,0,0,4,1,1,3,0,0,5
24.10.2018,Чикаго,Анахайм,1,0,2,0,0,3,0,1,0,0,0,1
24.10.2018,Даллас,Лос-Анджелес,1,2,1,0,0,4,0,2,0,0,0,2
24.10.2018,Эдмонтон,Питтсбург,0,3,2,0,0,5,1,3,1,1,0,6
25.10.2018,Виннипег,Торонто,0,0,2,0,0,2,1,2,1,0,0,4
25.10.2018,Айлендерс,Флорида,1,1,0,0,0,2,0,0,2,1,0,3
25.10.2018,Колорадо,Тампа-Бэй,0,0,0,0,0,0,0,0,1,0,0,1
25.10.2018,Вегас,Ванкувер,0,2,0,0,0,2,0,2,0,0,1,3
26.10.2018,Бостон,Филадельфия,0,2,1,0,0,3,0,0,0,0,0,0
26.10.2018,Баффало,Монреаль,0,2,2,0,0,4,1,1,1,0,0,3
26.10.2018,Нью-Джерси,Нэшвилл,2,1,0,0,0,3,1,1,1,1,0,4
26.10.2018,Миннесота,Лос-Анджелес,1,1,2,0,0,4,0,0,1,0,0,1
26.10.2018,Сент-Луис,Коламбус,2,1,1,0,0,4,1,3,3,0,0,7
26.10.2018,Чикаго,Рейнджерс,1,1,2,0,0,4,1,0,0,0,0,1
26.10.2018,Даллас,Анахайм,2,3,0,0,0,5,1,1,0,0,0,2
26.10.2018,Эдмонтон,Вашингтон,1,1,2,0,0,4,0,1,0,0,0,1
26.10.2018,Калгари,Питтсбург,0,0,1,0,0,1,3,4,2,0,0,9
26.10.2018,Аризона,Ванкувер,0,1,3,0,0,4,0,1,0,0,0,1
27.10.2018,Вегас,Тампа-Бэй,1,0,1,0,0,2,2,1,0,0,0,3
27.10.2018,Детройт,Виннипег,1,0,0,0,0,1,0,1,1,0,0,2
27.10.2018,Каролина,Сан-Хосе,0,3,0,0,1,4,2,1,0,0,0,3
27.10.2018,Колорадо,Оттава,0,2,4,0,0,6,2,1,0,0,0,3
27.10.2018,Нью-Джерси,Флорида,1,2,0,0,0,3,0,0,2,0,0,2
27.10.2018,Филадельфия,Айлендерс,0,1,0,0,0,1,2,1,3,0,0,6
27.10.2018,Нэшвилл,Эдмонтон,0,1,2,0,0,3,1,2,2,0,0,5
27.10.2018,Калгари,Вашингтон,2,0,1,0,0,3,2,1,0,0,1,4
28.10.2018,Торонто,Виннипег,0,0,3,0,0,3,1,1,0,0,0,2
28.10.2018,Коламбус,Баффало,1,3,0,1,0,5,2,0,2,0,0,4
28.10.2018,Бостон,Монреаль,0,0,0,0,0,0,2,0,1,0,0,3
28.10.2018,Миннесота,Колорадо,0,1,2,0,0,3,1,0,1,0,0,2
28.10.2018,Сент-Луис,Чикаго,2,2,3,0,0,7,2,1,0,0,0,3
28.10.2018,Аризона,Тампа-Бэй,3,2,2,0,0,7,0,0,1,0,0,1
28.10.2018,Ванкувер,Питтсбург,0,0,0,0,0,0,0,2,3,0,0,5
28.10.2018,Лос-Анджелес,Рейнджерс,0,2,2,0,0,4,1,1,1,0,0,3
29.10.2018,Каролина,Айлендерс,0,1,0,0,0,1,1,1,0,0,0,2
29.10.2018,Детройт,Даллас,0,1,3,0,0,4,1,0,1,0,0,2
29.10.2018,Чикаго,Эдмонтон,1,0,0,0,0,1,1,0,0,1,0,2
29.10.2018,Анахайм,Сан-Хосе,1,1,1,0,0,3,1,2,0,1,0,4
29.10.2018,Вегас,Оттава,0,2,1,1,0,4,1,1,1,0,0,3
30.10.2018,Торонто,Калгари,0,0,1,0,0,1,0,0,3,0,0,3
30.10.2018,Ванкувер,Миннесота,1,2,2,0,0,5,1,1,0,0,0,2
31.10.2018,Баффало,Калгари,1,0,0,0,0,1,0,0,1,1,0,2
31.10.2018,Питтсбург,Айлендерс,2,0,1,0,0,3,2,3,1,0,0,6
31.10.2018,Каролина,Бостон,1,1,0,0,0,2,0,2,1,0,0,3
31.10.2018,Коламбус,Детройт,0,0,3,0,0,3,3,0,2,0,0,5
31.10.2018,Тампа-Бэй,Нью-Джерси,2,3,3,0,0,8,2,1,0,0,0,3
31.10.2018,Монреаль,Даллас,0,0,1,0,0,1,0,2,2,0,0,4
31.10.2018,Нэшвилл,Вегас,0,2,2,0,0,4,1,0,0,0,0,1
31.10.2018,Эдмонтон,Миннесота,1,2,0,0,0,3,1,2,1,0,0,4
31.10.2018,Аризона,Оттава,3,1,1,0,0,5,0,1,0,0,0,1
31.10.2018,Анахайм,Филадельфия,0,1,1,0,0,2,1,1,1,0,0,3
31.10.2018,Сан-Хосе,Рейнджерс,1,0,2,0,0,3,1,0,2,0,1,4
01.11.2018,Ванкувер,Чикаго,1,1,2,0,0,4,1,1,0,0,0,2
01.11.2018,Флорида,Виннипег,0,2,0,0,0,2,1,1,2,0,0,4
02.11.2018,Айлендерс,Питтсбург,0,1,1,0,1,3,1,0,1,0,0,2
02.11.2018,Торонто,Даллас,0,0,1,0,0,1,0,1,1,0,0,2
02.11.2018,Тампа-Бэй,Нэшвилл,0,1,0,0,0,1,2,0,2,0,0,4
02.11.2018,Детройт,Нью-Джерси,1,0,3,0,0,4,0,1,2,0,0,3
02.11.2018,Оттава,Баффало,1,2,1,0,0,4,0,0,2,0,0,2
02.11.2018,Монреаль,Вашингтон,1,2,3,0,0,6,1,3,0,0,0,4
02.11.2018,Сент-Луис,Вегас,1,3,1,0,0,5,1,1,1,0,0,3
02.11.2018,Эдмонтон,Чикаго,0,2,2,0,0,4,0,0,0,0,0,0
02.11.2018,Калгари,Колорадо,0,1,5,0,0,6,0,4,1,0,0,5
02.11.2018,Анахайм,Рейнджерс,0,1,1,0,0,2,0,2,0,0,1,3
02.11.2018,Лос-Анджелес,Филадельфия,0,2,0,0,0,2,1,2,2,0,0,5
02.11.2018,Сан-Хосе,Коламбус,1,0,0,0,0,1,1,2,1,0,0,4
02.11.2018,Виннипег,Флорида,2,0,0,0,0,2,1,2,1,0,0,4
03.11.2018,Ванкувер,Колорадо,1,3,2,1,0,7,0,4,2,0,0,6
03.11.2018,Аризона,Каролина,3,0,0,1,0,4,0,1,2,0,0,3
03.11.2018,Баффало,Оттава,3,4,2,0,0,9,0,1,1,0,0,2
04.11.2018,Питтсбург,Торонто,0,0,0,0,0,0,1,2,2,0,0,5
04.11.2018,Вашингтон,Даллас,0,2,1,0,0,3,2,1,0,1,0,4
04.11.2018,Детройт,Эдмонтон,1,1,1,0,0,3,1,2,1,0,0,4
04.11.2018,Монреаль,Тампа-Бэй,1,0,0,0,0,1,2,0,2,0,0,4
04.11.2018,Айлендерс,Нью-Джерси,1,0,2,0,0,3,0,0,0,0,0,0
04.11.2018,Нэшвилл,Бостон,1,0,0,0,0,1,0,0,0,0,0,0
04.11.2018,Сент-Луис,Миннесота,1,0,0,0,0,1,3,1,1,0,0,5
04.11.2018,Калгари,Чикаго,1,1,3,0,0,5,2,1,0,0,0,3
04.11.2018,Вегас,Каролина,1,1,1,0,0,3,0,0,0,0,0,0
04.11.2018,Сан-Хосе,Филадельфия,1,1,1,1,0,4,2,1,0,0,0,3
04.11.2018,Лос-Анджелес,Коламбус,1,1,2,0,0,4,0,0,1,0,0,1
05.11.2018,Оттава,Тампа-Бэй,2,0,1,0,0,3,0,1,2,1,0,4
05.11.2018,Рейнджерс,Баффало,0,2,1,0,0,3,0,0,1,0,0,1
05.11.2018,Анахайм,Коламбус,0,2,0,1,0,3,0,1,1,0,0,2
06.11.2018,Питтсбург,Нью-Джерси,1,0,0,0,0,1,2,2,1,0,0,5
06.11.2018,Бостон,Даллас,1,0,0,1,0,2,1,0,0,0,0,1
06.11.2018,Вашингтон,Эдмонтон,2,2,0,0,0,4,1,1,0,0,0,2
06.11.2018,Айлендерс,Монреаль,3,0,0,0,0,3,1,1,1,0,1,4
06.11.2018,Аризона,Филадельфия,0,1,1,0,0,2,2,1,2,0,0,5
07.11.2018,Торонто,Вегас,1,1,1,0,0,3,0,1,0,0,0,1
07.11.2018,Рейнджерс,Монреаль,1,1,3,0,0,5,1,2,0,0,0,3
07.11.2018,Коламбус,Даллас,1,2,1,0,0,4,0,0,1,0,0,1
07.11.2018,Детройт,Ванкувер,0,1,1,0,1,3,1,1,0,0,0,2
07.11.2018,Оттава,Нью-Джерси,2,3,2,0,0,7,2,0,1,0,0,3
07.11.2018,Тампа-Бэй,Эдмонтон,2,2,1,0,0,5,0,1,1,0,0,2
07.11.2018,Сент-Луис,Каролина,3,0,1,0,0,4,1,0,0,0,0,1
07.11.2018,Лос-Анджелес,Анахайм,2,1,1,0,0,4,0,1,0,0,0,1
07.11.2018,Сан-Хосе,Миннесота,1,2,1,0,0,4,0,1,2,0,0,3
08.11.2018,Вашингтон,Питтсбург,0,1,1,0,0,2,1,0,0,0,0,1
08.11.2018,Колорадо,Нэшвилл,0,1,0,0,0,1,2,1,1,0,0,4
08.11.2018,Анахайм,Калгари,2,0,1,0,0,3,1,0,1,0,0,2
09.11.2018,Филадельфия,Аризона,2,0,2,1,0,5,1,3,0,0,0,4
09.11.2018,Флорида,Эдмонтон,0,2,2,0,0,4,0,0,1,0,0,1
09.11.2018,Бостон,Ванкувер,1,3,1,0,0,5,1,5,2,0,0,8
09.11.2018,Тампа-Бэй,Айлендерс,0,2,2,0,0,4,1,0,1,0,0,2
09.11.2018,Оттава,Вегас,0,1,2,0,0,3,2,1,2,0,0,5
09.11.2018,Монреаль,Баффало,3,2,0,0,0,5,3,1,1,1,0,6
09.11.2018,Чикаго,Каролина,0,2,1,0,0,3,3,1,0,0,0,4
09.11.2018,Даллас,Сан-Хосе,1,2,1,0,0,4,1,1,1,0,0,3
09.11.2018,Лос-Анджелес,Миннесота,1,0,0,0,0,1,1,1,1,0,0,3
10.11.2018,Вашингтон,Коламбус,0,1,0,0,0,1,1,0,1,0,0,2
10.11.2018,Торонто,Нью-Джерси,1,4,1,0,0,6,0,1,0,0,0,1
10.11.2018,Детройт,Рейнджерс,0,0,2,1,0,3,0,2,0,0,0,2
10.11.2018,Виннипег,Колорадо,2,0,3,0,0,5,0,0,2,0,0,2
10.11.2018,Сент-Луис,Сан-Хосе,1,2,1,0,0,4,0,0,0,0,0,0
10.11.2018,Анахайм,Миннесота,0,1,0,0,0,1,1,2,2,0,0,5
10.11.2018,Филадельфия,Чикаго,1,1,2,0,0,4,0,0,0,0,0,0
10.11.2018,Баффало,Ванкувер,1,0,2,0,1,4,0,2,1,0,0,3
10.11.2018,Даллас,Нэшвилл,1,2,1,0,0,4,0,1,3,1,0,5
11.11.2018,Коламбус,Рейнджерс,1,3,0,0,0,4,1,3,0,0,1,5
11.11.2018,Монреаль,Вегас,0,3,2,0,0,5,2,1,1,0,0,4
11.11.2018,Питтсбург,Аризона,0,3,1,0,0,4,0,0,0,0,0,0
11.11.2018,Бостон,Торонто,1,2,2,0,0,5,0,1,0,0,0,1
11.11.2018,Флорида,Айлендерс,1,1,2,0,0,4,1,1,0,0,0,2
11.11.2018,Каролина,Детройт,1,2,0,0,0,3,1,0,2,0,1,4
11.11.2018,Тампа-Бэй,Оттава,1,3,0,0,0,4,2,0,4,0,0,6
11.11.2018,Лос-Анджелес,Калгари,0,0,0,0,0,0,1,0,0,0,0,1
11.11.2018,Сент-Луис,Миннесота,1,1,0,0,0,2,0,2,1,0,0,3
12.11.2018,Вашингтон,Аризона,0,1,0,0,0,1,1,2,1,0,0,4
12.11.2018,Флорида,Оттава,0,5,0,0,0,5,1,0,0,0,0,1
12.11.2018,Виннипег,Нью-Джерси,2,3,0,0,0,5,1,1,0,0,0,2
12.11.2018,Бостон,Вегас,2,1,1,0,0,4,0,1,0,0,0,1
12.11.2018,Сан-Хосе,Калгари,1,1,1,0,0,3,0,1,0,0,0,1
12.11.2018,Эдмонтон,Колорадо,0,0,1,0,0,1,2,2,0,0,0,4
13.11.2018,Каролина,Чикаго,0,2,0,1,0,3,1,1,0,0,0,2
13.11.2018,Рейнджерс,Ванкувер,0,1,1,0,0,2,0,1,0,0,0,1
13.11.2018,Даллас,Коламбус,0,1,0,0,0,1,0,1,1,0,0,2
13.11.2018,Анахайм,Нэшвилл,0,1,0,0,1,2,0,0,1,0,0,1
14.11.2018,Айлендерс,Ванкувер,3,0,2,0,0,5,1,1,0,0,0,2
14.11.2018,Филадельфия,Флорида,0,0,1,0,0,1,0,2,0,0,0,2
14.11.2018,Нью-Джерси,Питтсбург,1,1,2,0,0,4,1,0,1,0,0,2
14.11.2018,Детройт,Аризона,3,1,2,0,0,6,0,0,1,0,0,1
14.11.2018,Баффало,Тампа-Бэй,1,1,0,0,0,2,0,1,0,0,0,1
14.11.2018,Миннесота,Вашингтон,0,1,1,0,0,2,2,1,2,0,0,5
14.11.2018,Эдмонтон,Монреаль,2,1,3,0,0,6,1,1,0,0,0,2
14.11.2018,Лос-Анджелес,Торонто,1,0,0,0,0,1,2,3,0,0,0,5
14.11.2018,Сан-Хосе,Нэшвилл,3,0,2,0,0,5,0,3,1,0,0,4
15.11.2018,Чикаго,Сент-Луис,0,1,0,0,0,1,0,0,0,0,0,0
15.11.2018,Виннипег,Вашингтон,0,1,2,0,0,3,1,0,0,0,0,1
15.11.2018,Колорадо,Бостон,1,1,4,0,0,6,2,1,0,0,0,3
15.11.2018,Вегас,Анахайм,1,3,1,0,0,5,0,0,0,0,0,0
16.11.2018,Коламбус,Флорида,0,3,4,0,0,7,2,1,0,0,0,3
16.11.2018,Питтсбург,Тампа-Бэй,2,1,0,0,0,3,1,3,0,0,0,4
16.11.2018,Айлендерс,Рейнджерс,2,3,2,0,0,7,2,1,2,0,0,5
16.11.2018,Филадельфия,Нью-Джерси,0,0,0,0,0,0,1,0,2,0,0,3
16.11.2018,Оттава,Детройт,1,1,0,0,0,2,0,1,0,0,0,1
16.11.2018,Миннесота,Ванкувер,2,3,1,0,0,6,0,1,1,0,0,2
16.11.2018,Аризона,Нэшвилл,1,1,0,0,0,2,0,0,1,0,0,1
16.11.2018,Калгари,Монреаль,0,2,0,0,0,2,1,0,2,0,0,3
16.11.2018,Сан-Хосе,Торонто,3,0,0,0,0,3,2,2,1,0,0,5
17.11.2018,Даллас,Бостон,0,0,0,1,0,1,0,0,0,0,0,0
17.11.2018,Виннипег,Баффало,0,1,0,0,0,1,0,0,1,0,1,2
17.11.2018,Чикаго,Лос-Анджелес,0,0,1,0,0,1,0,1,0,0,1,2
17.11.2018,Колорадо,Вашингтон,1,0,1,0,0,2,0,2,0,1,0,3
17.11.2018,Вегас,Сент-Луис,1,0,0,0,0,1,1,3,0,0,0,4
17.11.2018,Анахайм,Торонто,0,1,0,0,0,1,1,0,0,1,0,2
17.11.2018,Нью-Джерси,Детройт,1,1,0,0,0,2,0,1,1,1,0,3
17.11.2018,Филадельфия,Тампа-Бэй,0,1,4,0,0,5,0,3,2,1,0,6
18.11.2018,Миннесота,Баффало,2,0,0,0,0,2,1,0,2,0,0,3
18.11.2018,Ванкувер,Монреаль,0,1,1,0,0,2,0,1,2,0,0,3
18.11.2018,Оттава,Питтсбург,3,2,1,0,0,6,1,0,3,0,0,4
18.11.2018,Рейнджерс,Флорида,2,1,1,0,0,4,2,0,0,0,0,2
18.11.2018,Каролина,Коламбус,0,1,0,0,0,1,1,3,0,0,0,4
18.11.2018,Нэшвилл,Лос-Анджелес,0,2,3,0,0,5,0,3,0,0,0,3
18.11.2018,Аризона,Бостон,0,1,0,0,0,1,2,0,0,0,0,2
18.11.2018,Калгари,Эдмонтон,0,1,3,0,0,4,1,1,0,0,0,2
18.11.2018,Сан-Хосе,Сент-Луис,0,3,1,0,0,4,0,0,0,0,0,0
18.11.2018,Айлендерс,Даллас,1,0,1,0,0,2,0,4,2,0,0,6
19.11.2018,Каролина,Нью-Джерси,2,0,0,0,0,2,1,0,0,0,0,1
19.11.2018,Чикаго,Миннесота,2,0,1,0,0,3,0,1,0,0,0,1
19.11.2018,Эдмонтон,Вегас,2,0,1,0,0,3,1,3,2,0,0,6
19.11.2018,Анахайм,Колорадо,1,2,0,0,0,3,0,2,1,1,0,4
20.11.2018,Торонто,Коламбус,0,2,2,0,0,4,2,0,0,0,0,2
20.11.2018,Рейнджерс,Даллас,0,1,1,0,0,2,0,1,0,0,0,1
20.11.2018,Питтсбург,Баффало,2,2,0,0,0,4,1,2,1,1,0,5
20.11.2018,Оттава,Флорида,1,2,2,0,0,5,4,2,1,0,0,7
20.11.2018,Монреаль,Вашингтон,1,3,0,0,0,4,2,1,1,1,0,5
20.11.2018,Нэшвилл,Тампа-Бэй,1,2,0,0,0,3,1,0,1,0,0,2
20.11.2018,Сент-Луис,Лос-Анджелес,0,0,0,0,0,0,0,1,1,0,0,2
20.11.2018,Калгари,Вегас,5,2,0,0,0,7,0,0,2,0,0,2
20.11.2018,Ванкувер,Виннипег,1,2,0,0,0,3,3,1,2,0,0,6
21.11.2018,Сан-Хосе,Эдмонтон,2,1,0,0,0,3,1,1,1,1,0,4
22.11.2018,Питтсбург,Даллас,3,2,0,0,0,5,0,0,1,0,0,1
22.11.2018,Рейнджерс,Айлендерс,3,1,1,0,0,5,0,0,0,0,0,0
22.11.2018,Нью-Джерси,Монреаль,2,3,0,0,0,5,1,0,1,0,0,2
22.11.2018,Каролина,Торонто,2,0,3,0,0,5,1,0,1,0,0,2
22.11.2018,Вашингтон,Чикаго,2,1,1,0,0,4,0,1,1,0,0,2
22.11.2018,Детройт,Бостон,0,1,1,1,0,3,0,1,1,0,0,2
22.11.2018,Баффало,Филадельфия,4,0,1,0,0,5,0,2,0,0,0,2
22.11.2018,Тампа-Бэй,Флорида,2,2,3,0,0,7,1,1,1,0,0,3
22.11.2018,Миннесота,Оттава,2,2,2,0,0,6,0,1,3,0,0,4
22.11.2018,Нэшвилл,Сент-Луис,1,1,2,0,0,4,1,0,0,0,0,1
22.11.2018,Аризона,Вегас,1,0,1,0,0,2,0,2,0,1,0,3
22.11.2018,Анахайм,Ванкувер,1,1,2,0,0,4,0,1,2,0,0,3
22.11.2018,Калгари,Виннипег,5,0,1,0,0,6,1,1,1,0,0,3
22.11.2018,Лос-Анджелес,Колорадо,1,0,2,0,0,3,2,2,3,0,0,7
23.11.2018,Филадельфия,Рейнджерс,1,0,3,0,0,4,0,0,0,0,0,0
24.11.2018,Баффало,Монреаль,1,0,1,1,0,3,0,1,1,0,0,2
24.11.2018,Вашингтон,Детройт,0,1,2,0,0,3,1,0,0,0,0,1
24.11.2018,Миннесота,Виннипег,0,0,4,0,0,4,1,1,0,0,0,2
24.11.2018,Нью-Джерси,Айлендерс,0,1,2,0,0,3,1,1,1,1,0,4
24.11.2018,Анахайм,Эдмонтон,0,0,1,1,0,2,0,0,1,0,0,1
24.11.2018,Вегас,Калгари,0,1,1,0,0,2,0,0,0,0,0,0
24.11.2018,Коламбус,Торонто,2,1,1,0,0,4,1,1,0,0,0,2
24.11.2018,Тампа-Бэй,Чикаго,4,0,0,0,0,4,1,1,0,0,0,2
24.11.2018,Каролина,Флорида,1,0,3,0,0,4,0,0,1,0,0,1
24.11.2018,Бостон,Питтсбург,0,1,0,1,0,2,0,1,0,0,0,1
24.11.2018,Аризона,Колорадо,0,0,1,0,0,1,3,0,2,0,0,5
24.11.2018,Сент-Луис,Нэшвилл,3,2,1,0,0,6,1,0,1,0,0,2
24.11.2018,Даллас,Оттава,1,2,3,0,0,6,1,1,2,0,0,4
24.11.2018,Сан-Хосе,Ванкувер,2,0,2,0,0,4,0,0,0,0,0,0
24.11.2018,Рейнджерс,Вашингтон,1,1,1,0,0,3,0,3,2,0,0,5
25.11.2018,Торонто,Филадельфия,4,2,0,0,0,6,0,0,0,0,0,0
25.11.2018,Айлендерс,Каролина,2,1,1,0,0,4,0,0,1,0,0,1
25.11.2018,Питтсбург,Коламбус,3,1,0,0,0,4,1,1,0,0,0,2
25.11.2018,Детройт,Баффало,0,1,1,0,0,2,1,0,1,0,1,3
25.11.2018,Монреаль,Бостон,0,0,2,0,0,2,2,0,1,0,0,3
25.11.2018,Сент-Луис,Виннипег,2,0,2,0,0,4,2,4,2,0,0,8
25.11.2018,Флорида,Чикаго,2,2,0,0,0,4,0,2,2,1,0,5
25.11.2018,Колорадо,Даллас,0,1,2,0,0,3,0,0,2,0,0,2
25.11.2018,Лос-Анджелес,Ванкувер,0,2,0,0,0,2,0,2,2,0,0,4
25.11.2018,Вегас,Сан-Хосе,4,1,1,0,0,6,0,0,0,0,0,0
25.11.2018,Аризона,Калгари,0,0,1,0,0,1,2,2,2,0,0,6
26.11.2018,Тампа-Бэй,Нью-Джерси,4,1,0,0,0,5,1,0,1,0,0,2
26.11.2018,Нэшвилл,Анахайм,1,2,2,0,0,5,0,2,0,0,0,2
26.11.2018,Лос-Анджелес,Эдмонтон,1,1,3,0,0,5,1,1,0,0,0,2
27.11.2018,Рейнджерс,Оттава,1,0,3,0,0,4,1,0,1,0,0,2
27.11.2018,Айлендерс,Вашингтон,1,0,0,0,0,1,1,1,2,0,0,4
27.11.2018,Торонто,Бостон,1,2,1,0,0,4,0,2,0,0,0,2
27.11.2018,Флорида,Нью-Джерси,0,2,1,1,0,4,0,2,1,0,0,3
27.11.2018,Детройт,Коламбус,0,3,2,0,0,5,3,2,2,0,0,7
28.11.2018,Баффало,Сан-Хосе,0,1,1,1,0,3,0,0,2,0,0,2
28.11.2018,Филадельфия,Оттава,1,2,0,0,0,3,1,0,3,0,0,4
28.11.2018,Тампа-Бэй,Анахайм,0,1,0,0,0,1,0,1,2,0,0,3
28.11.2018,Монреаль,Каролина,0,0,1,0,0,1,1,1,0,0,0,2
28.11.2018,Виннипег,Питтсбург,1,2,0,0,0,3,1,1,2,0,0,4
28.11.2018,Чикаго,Вегас,0,2,1,0,0,3,3,3,2,0,0,8
28.11.2018,Миннесота,Аризона,1,2,0,0,0,3,1,0,3,0,0,4
28.11.2018,Нэшвилл,Колорадо,1,1,0,0,0,2,1,1,1,0,0,3
28.11.2018,Эдмонтон,Даллас,0,0,0,1,0,1,0,0,0,0,0,0
28.11.2018,Ванкувер,Лос-Анджелес,0,0,1,0,0,1,0,1,0,1,0,2
29.11.2018,Детройт,Сент-Луис,0,3,1,0,0,4,0,2,1,0,0,3
29.11.2018,Флорида,Анахайм,0,2,0,0,0,2,1,1,1,0,0,3
29.11.2018,Торонто,Сан-Хосе,3,1,1,0,0,5,1,1,1,0,0,3
29.11.2018,Калгари,Даллас,1,0,2,0,0,3,1,1,1,1,0,4
29.11.2018,Колорадо,Питтсбург,1,2,3,0,0,6,0,2,1,0,0,3
30.11.2018,Коламбус,Миннесота,1,3,0,0,0,4,1,1,0,0,0,2
30.11.2018,Оттава,Рейнджерс,2,1,0,0,0,3,0,0,0,0,0,0
30.11.2018,Тампа-Бэй,Баффало,3,0,2,0,0,5,2,1,1,0,0,4
30.11.2018,Нэшвилл,Аризона,0,0,0,0,0,0,0,2,1,0,0,3
30.11.2018,Виннипег,Чикаго,2,2,2,0,0,6,2,1,2,0,0,5
30.11.2018,Бостон,Айлендерс,0,1,0,0,1,2,1,0,0,0,0,1
30.11.2018,Эдмонтон,Лос-Анджелес,2,0,1,0,0,3,2,0,0,0,0,2
30.11.2018,Ванкувер,Вегас,1,0,2,0,0,3,1,1,2,0,0,4
01.12.2018,Флорида,Баффало,1,0,1,1,0,3,1,1,0,0,0,2
01.12.2018,Вашингтон,Нью-Джерси,1,1,4,0,0,6,0,1,2,0,0,3
01.12.2018,Каролина,Анахайм,1,0,0,0,0,1,0,0,1,1,0,2
01.12.2018,Колорадо,Сент-Луис,0,1,1,0,0,2,2,0,0,1,0,3
01.12.2018,Калгари,Лос-Анджелес,1,0,3,0,0,4,0,1,0,0,0,1
01.12.2018,Оттава,Сан-Хосе,0,3,3,0,0,6,0,1,1,0,0,2
02.12.2018,Ванкувер,Даллас,1,0,0,0,0,1,0,0,2,0,0,2
02.12.2018,Бостон,Детройт,1,0,1,0,0,2,0,2,2,0,0,4
02.12.2018,Нью-Джерси,Виннипег,1,0,2,0,0,3,0,1,2,1,0,4
02.12.2018,Питтсбург,Филадельфия,1,1,0,0,0,2,1,1,2,0,0,4
02.12.2018,Миннесота,Торонто,1,1,1,0,0,3,2,1,2,0,0,5
02.12.2018,Флорида,Тампа-Бэй,2,2,0,0,0,4,1,2,1,1,0,5
02.12.2018,Айлендерс,Коламбус,0,2,1,0,0,3,0,2,0,0,0,2
02.12.2018,Монреаль,Рейнджерс,2,2,1,0,0,5,0,2,0,0,0,2
02.12.2018,Аризона,Сент-Луис,1,4,1,0,0,6,0,1,0,0,0,1
02.12.2018,Нэшвилл,Чикаго,4,0,1,0,0,5,1,1,0,0,0,2
02.12.2018,Эдмонтон,Вегас,1,0,1,0,0,2,0,1,0,0,0,1
02.12.2018,Вашингтон,Анахайм,3,2,0,0,0,5,1,2,3,0,0,6
03.12.2018,Рейнджерс,Виннипег,1,2,0,0,0,3,0,0,3,0,1,4
03.12.2018,Чикаго,Калгари,1,1,0,0,0,2,1,2,0,0,0,3
03.12.2018,Детройт,Колорадо,0,0,0,0,0,0,0,1,1,0,0,2
03.12.2018,Монреаль,Сан-Хосе,0,1,0,0,0,1,2,1,0,0,0,3
03.12.2018,Лос-Анджелес,Каролина,0,0,2,0,0,2,0,0,0,0,0,0
04.12.2018,Нью-Джерси,Тампа-Бэй,0,1,0,0,0,1,2,2,1,0,0,5
04.12.2018,Нэшвилл,Баффало,1,1,0,0,0,2,0,1,0,0,0,1
04.12.2018,Даллас,Эдмонтон,1,0,3,0,0,4,0,0,1,0,0,1
05.12.2018,Айлендерс,Виннипег,0,0,1,0,0,1,0,0,3,0,0,3
05.12.2018,Флорида,Бостон,0,4,1,0,0,5,0,0,0,0,0,0
05.12.2018,Питтсбург,Колорадо,3,0,3,0,0,6,0,3,0,0,0,3
05.12.2018,Коламбус,Калгари,3,2,1,0,0,6,1,5,3,0,0,9
05.12.2018,Детройт,Тампа-Бэй,2,2,1,0,0,5,0,3,2,0,1,6
05.12.2018,Баффало,Торонто,0,1,2,0,0,3,0,2,1,1,0,4
05.12.2018,Монреаль,Оттава,1,3,1,0,0,5,0,1,1,0,0,2
05.12.2018,Ванкувер,Миннесота,1,1,0,0,0,2,1,2,0,0,0,3
05.12.2018,Вегас,Вашингтон,1,0,4,0,0,5,1,1,1,0,0,3
05.12.2018,Лос-Анджелес,Аризона,0,0,1,0,0,1,1,1,0,0,0,2
06.12.2018,Сент-Луис,Эдмонтон,2,0,0,0,0,2,0,1,1,0,1,3
06.12.2018,Сан-Хосе,Каролина,2,2,1,0,0,5,0,1,0,0,0,1
06.12.2018,Анахайм,Чикаго,2,0,2,0,0,4,0,2,0,0,0,2
07.12.2018,Флорида,Колорадо,1,1,0,0,0,2,1,1,3,0,0,5
07.12.2018,Питтсбург,Айлендерс,2,3,1,0,0,6,1,0,1,0,0,2
07.12.2018,Филадельфия,Коламбус,1,0,2,0,0,3,2,0,1,1,0,4
07.12.2018,Торонто,Детройт,1,0,3,0,0,4,3,1,0,1,0,5
07.12.2018,Оттава,Монреаль,1,1,0,0,0,2,1,2,2,0,0,5
07.12.2018,Тампа-Бэй,Бостон,1,0,2,0,0,3,1,0,1,0,0,2
07.12.2018,Калгари,Миннесота,0,1,1,0,0,2,0,0,0,0,0,0
07.12.2018,Аризона,Вашингтон,1,1,0,0,0,2,0,2,2,0,0,4
07.12.2018,Ванкувер,Нэшвилл,2,2,1,0,0,5,0,1,2,0,0,3
07.12.2018,Вегас,Чикаго,2,0,2,0,0,4,0,2,1,0,0,3
07.12.2018,Лос-Анджелес,Нью-Джерси,1,2,0,0,0,3,1,3,2,0,0,6
08.12.2018,Виннипег,Сент-Луис,0,0,0,0,0,0,0,1,0,0,0,1
08.12.2018,Даллас,Сан-Хосе,0,1,2,0,0,3,1,0,1,0,0,2
08.12.2018,Эдмонтон,Миннесота,3,0,4,0,0,7,1,0,1,0,0,2
08.12.2018,Анахайм,Каролина,1,0,0,0,0,1,0,1,3,0,0,4
08.12.2018,Баффало,Филадельфия,2,0,0,0,0,2,1,1,4,0,0,6
09.12.2018,Лос-Анджелес,Вегас,1,2,2,0,0,5,1,0,0,0,0,1
09.12.2018,Тампа-Бэй,Колорадо,3,3,1,0,0,7,1,0,0,0,0,1
09.12.2018,Бостон,Торонто,1,2,3,0,0,6,0,0,3,0,0,3
09.12.2018,Детройт,Айлендерс,2,0,0,0,0,2,0,2,1,0,0,3
09.12.2018,Коламбус,Вашингтон,0,0,0,0,0,0,3,0,1,0,0,4
09.12.2018,Оттава,Питтсбург,1,0,0,1,0,2,0,1,0,0,0,1
09.12.2018,Флорида,Рейнджерс,0,3,1,0,0,4,2,1,1,0,1,5
09.12.2018,Аризона,Сан-Хосе,0,2,1,0,0,3,2,1,2,0,0,5
09.12.2018,Калгари,Нэшвилл,1,1,3,0,0,5,1,0,1,0,0,2
09.12.2018,Сент-Луис,Ванкувер,0,0,1,0,0,1,3,2,1,0,0,6
09.12.2018,Виннипег,Филадельфия,2,3,2,0,0,7,1,0,0,0,0,1
10.12.2018,Оттава,Бостон,1,0,0,0,0,1,0,1,0,1,0,2
10.12.2018,Чикаго,Монреаль,1,1,0,0,0,2,2,0,1,0,0,3
10.12.2018,Анахайм,Нью-Джерси,3,0,2,0,1,6,3,1,1,0,0,5
10.12.2018,Эдмонтон,Калгари,1,0,0,0,0,1,0,0,0,0,0,0
10.12.2018,Вегас,Даллас,1,2,1,0,0,4,1,0,1,0,0,2
11.12.2018,Айлендерс,Питтсбург,0,1,0,0,0,1,0,0,1,0,1,2
11.12.2018,Тампа-Бэй,Рейнджерс,1,2,3,0,0,6,2,0,1,0,0,3
11.12.2018,Детройт,Лос-Анджелес,1,2,0,0,0,3,0,0,1,0,0,1
11.12.2018,Сан-Хосе,Нью-Джерси,2,2,1,0,0,5,1,1,0,0,0,2
12.12.2018,Коламбус,Ванкувер,1,0,1,0,0,2,0,0,3,0,0,3
12.12.2018,Бостон,Аризона,0,4,0,0,0,4,2,1,0,0,0,3
12.12.2018,Каролина,Торонто,0,1,0,0,0,1,1,1,2,0,0,4
12.12.2018,Баффало,Лос-Анджелес,1,0,2,1,0,4,1,2,0,0,0,3
12.12.2018,Вашингтон,Детройт,3,2,1,0,0,6,0,0,2,0,0,2
12.12.2018,Миннесота,Монреаль,1,4,2,0,0,7,0,0,1,0,0,1
12.12.2018,Виннипег,Чикаго,3,1,2,0,0,6,0,2,1,0,0,3
12.12.2018,Нэшвилл,Оттава,1,1,1,0,0,3,1,0,0,0,0,1
12.12.2018,Сент-Луис,Флорида,0,0,4,0,0,4,1,0,2,0,0,3
12.12.2018,Колорадо,Эдмонтон,0,1,3,0,0,4,1,4,1,0,0,6
13.12.2018,Айлендерс,Вегас,1,1,0,0,0,2,1,1,1,0,0,3
13.12.2018,Чикаго,Питтсбург,2,1,3,0,0,6,1,2,0,0,0,3
13.12.2018,Калгари,Филадельфия,1,2,2,1,0,6,0,4,1,0,0,5
13.12.2018,Анахайм,Даллас,1,1,4,0,0,6,0,3,0,0,0,3
14.12.2018,Коламбус,Лос-Анджелес,2,2,0,0,0,4,1,0,0,0,0,1
14.12.2018,Баффало,Аризона,2,0,1,0,0,3,1,0,0,0,0,1
14.12.2018,Тампа-Бэй,Торонто,1,3,0,0,0,4,1,0,0,0,0,1
14.12.2018,Монреаль,Каролина,0,2,4,0,0,6,0,1,3,0,0,4
14.12.2018,Миннесота,Флорида,1,2,2,0,0,5,1,0,0,0,0,1
14.12.2018,Виннипег,Эдмонтон,2,1,1,1,0,5,1,3,0,0,0,4
14.12.2018,Нэшвилл,Ванкувер,2,1,0,1,0,4,1,0,2,0,0,3
14.12.2018,Сан-Хосе,Даллас,0,1,2,0,0,3,0,1,1,0,0,2
15.12.2018,Рейнджерс,Аризона,2,1,0,0,0,3,0,1,2,1,0,4
15.12.2018,Нью-Джерси,Вегас,0,2,2,1,0,5,3,1,0,0,0,4
15.12.2018,Питтсбург,Бостон,1,2,2,0,0,5,0,1,2,0,0,3
15.12.2018,Детройт,Оттава,1,1,0,0,0,2,2,0,2,0,0,4
15.12.2018,Каролина,Вашингтон,2,2,1,0,0,5,1,3,1,0,1,6
15.12.2018,Сент-Луис,Колорадо,2,0,1,1,0,4,2,0,1,0,0,3
15.12.2018,Чикаго,Виннипег,1,1,1,0,0,3,1,2,0,1,0,4
15.12.2018,Эдмонтон,Филадельфия,1,2,1,0,0,4,0,0,1,0,0,1
15.12.2018,Миннесота,Калгари,0,1,0,0,0,1,1,0,1,0,0,2
16.12.2018,Монреаль,Оттава,1,0,4,0,0,5,1,1,0,0,0,2
16.12.2018,Питтсбург,Лос-Анджелес,2,1,0,1,0,4,0,2,1,0,0,3
16.12.2018,Вашингтон,Баффало,2,1,0,0,1,4,1,2,0,0,0,3
16.12.2018,Айлендерс,Детройт,1,0,2,0,1,4,2,0,1,0,0,3
16.12.2018,Флорида,Торонто,1,1,1,1,0,4,0,0,3,0,0,3
16.12.2018,Коламбус,Анахайм,1,0,0,0,0,1,1,0,0,1,0,2
16.12.2018,Нэшвилл,Нью-Джерси,1,0,0,0,1,2,0,0,1,0,0,1
16.12.2018,Колорадо,Даллас,3,1,2,0,0,6,0,2,2,0,0,4
16.12.2018,Ванкувер,Филадельфия,3,1,1,0,0,5,1,0,0,0,0,1
16.12.2018,Рейнджерс,Вегас,1,1,1,0,0,3,1,2,0,1,0,4
16.12.2018,Каролина,Аризона,0,2,1,0,0,3,0,0,0,0,0,0
16.12.2018,Сент-Луис,Калгари,0,2,0,0,0,2,4,1,2,0,0,7
17.12.2018,Бостон,Баффало,0,1,1,0,0,2,0,1,3,0,0,4
17.12.2018,Виннипег,Тампа-Бэй,1,2,1,1,0,5,1,2,1,0,0,4
17.12.2018,Чикаго,Сан-Хосе,3,0,0,0,0,3,2,3,2,0,0,7
17.12.2018,Ванкувер,Эдмонтон,0,2,2,0,0,4,0,1,1,0,0,2
18.12.2018,Коламбус,Вегас,0,0,1,0,0,1,0,0,0,0,0,0
18.12.2018,Питтсбург,Анахайм,2,0,0,0,0,2,0,3,1,0,0,4
18.12.2018,Оттава,Нэшвилл,3,0,0,1,0,4,0,1,2,0,0,3
18.12.2018,Монреаль,Бостон,0,0,0,0,0,0,1,1,2,0,0,4
18.12.2018,Колорадо,Айлендерс,0,1,0,0,0,1,1,2,1,0,0,4
19.12.2018,Баффало,Флорида,1,1,0,0,0,2,0,1,4,0,0,5
19.12.2018,Рейнджерс,Анахайм,0,0,3,0,0,3,0,1,0,0,0,1
19.12.2018,Нью-Джерси,Торонто,1,0,1,0,0,2,3,2,2,0,0,7
19.12.2018,Филадельфия,Детройт,1,2,0,0,0,3,0,1,1,0,0,2
19.12.2018,Миннесота,Сан-Хосе,0,0,0,0,0,0,0,2,2,0,0,4
19.12.2018,Чикаго,Нэшвилл,0,2,0,0,0,2,1,0,0,0,0,1
19.12.2018,Даллас,Калгари,1,1,0,0,0,2,0,0,0,0,0,0
19.12.2018,Аризона,Айлендерс,1,0,0,0,0,1,1,2,0,0,0,3
19.12.2018,Эдмонтон,Сент-Луис,0,1,0,0,0,1,1,0,3,0,0,4
19.12.2018,Ванкувер,Тампа-Бэй,1,0,1,0,0,2,2,1,2,0,0,5
19.12.2018,Лос-Анджелес,Виннипег,1,2,1,0,0,4,0,1,0,0,0,1
20.12.2018,Вашингтон,Питтсбург,0,1,0,0,0,1,0,2,0,0,0,2
20.12.2018,Колорадо,Монреаль,0,1,1,0,0,2,1,0,0,0,0,1
21.12.2018,Бостон,Анахайм,0,2,1,0,0,3,0,0,1,0,0,1
21.12.2018,Торонто,Флорида,1,2,3,0,0,6,0,0,1,0,0,1
21.12.2018,Филадельфия,Нэшвилл,1,1,0,0,0,2,0,1,0,0,0,1
21.12.2018,Питтсбург,Миннесота,1,0,1,0,0,2,1,0,0,0,0,1
21.12.2018,Каролина,Детройт,0,1,0,0,0,1,1,1,2,0,0,4
21.12.2018,Коламбус,Нью-Джерси,1,1,0,0,0,2,0,1,0,0,0,1
21.12.2018,Даллас,Чикаго,0,1,1,0,0,2,2,1,2,0,0,5
21.12.2018,Калгари,Тампа-Бэй,3,0,1,0,0,4,1,2,1,0,1,5
21.12.2018,Аризона,Монреаль,0,1,0,0,0,1,0,1,1,0,0,2
21.12.2018,Ванкувер,Сент-Луис,0,2,3,0,0,5,0,0,1,0,0,1
21.12.2018,Вегас,Айлендерс,0,1,3,0,0,4,2,0,0,0,0,2
21.12.2018,Сан-Хосе,Виннипег,2,1,0,0,0,3,3,0,2,0,0,5
22.12.2018,Вашингтон,Баффало,0,1,1,0,0,2,0,0,1,0,0,1
22.12.2018,Нью-Джерси,Оттава,2,3,0,0,0,5,0,2,0,0,0,2
22.12.2018,Колорадо,Чикаго,0,1,0,0,0,1,1,0,1,0,0,2
22.12.2018,Филадельфия,Коламбус,1,1,1,0,0,3,1,3,0,0,0,4
22.12.2018,Бостон,Нэшвилл,1,0,4,0,0,5,0,1,1,0,0,2
22.12.2018,Детройт,Флорида,0,1,0,0,0,1,2,0,0,0,0,2
23.12.2018,Сан-Хосе,Лос-Анджелес,0,0,2,0,0,2,1,0,1,1,0,3
23.12.2018,Калгари,Сент-Луис,1,0,0,0,0,1,2,0,1,0,0,3
23.12.2018,Вегас,Монреаль,1,2,0,0,0,3,1,1,1,1,0,4
23.12.2018,Оттава,Вашингтон,0,0,0,0,0,0,2,2,0,0,0,4
23.12.2018,Каролина,Питтсбург,0,0,0,0,0,0,1,2,0,0,0,3
23.12.2018,Торонто,Рейнджерс,1,0,4,0,0,5,0,1,2,0,0,3
23.12.2018,Баффало,Анахайм,1,0,2,0,0,3,0,0,0,0,0,0
23.12.2018,Аризона,Колорадо,2,2,2,0,0,6,1,0,3,0,0,4
23.12.2018,Миннесота,Даллас,0,0,1,0,0,1,0,0,1,1,0,2
23.12.2018,Ванкувер,Виннипег,0,0,0,0,0,0,0,0,1,0,0,1
23.12.2018,Эдмонтон,Тампа-Бэй,1,1,1,0,0,3,1,2,3,0,0,6
23.12.2018,Нью-Джерси,Коламбус,0,0,0,0,0,0,2,1,0,0,0,3
24.12.2018,Каролина,Бостон,1,3,1,0,0,5,2,1,0,0,0,3
24.12.2018,Чикаго,Флорида,1,1,1,0,0,3,1,3,2,0,0,6
24.12.2018,Рейнджерс,Филадельфия,1,0,1,0,0,2,0,1,1,0,1,3
24.12.2018,Торонто,Детройт,1,2,1,1,0,5,2,1,1,0,0,4
24.12.2018,Вегас,Лос-Анджелес,1,1,1,0,0,3,0,2,1,1,0,4
24.12.2018,Даллас,Айлендерс,0,1,0,0,0,1,0,1,2,0,0,3
24.12.2018,Сан-Хосе,Аризона,1,0,2,0,0,3,1,1,1,0,1,4
28.12.2018,Бостон,Нью-Джерси,0,1,1,0,0,2,2,0,3,0,0,5
28.12.2018,Рейнджерс,Коламбус,1,1,1,0,0,3,2,0,1,1,0,4
28.12.2018,Вашингтон,Каролина,0,2,1,0,0,3,0,0,1,0,0,1
28.12.2018,Питтсбург,Детройт,0,3,2,0,0,5,1,0,1,0,0,2
28.12.2018,Тампа-Бэй,Филадельфия,2,3,0,1,0,6,1,1,3,0,0,5
28.12.2018,Виннипег,Калгари,0,1,0,0,0,1,0,2,2,0,0,4
28.12.2018,Нэшвилл,Даллас,0,0,0,0,0,0,1,1,0,0,0,2
28.12.2018,Сент-Луис,Баффало,0,3,1,0,0,4,0,1,0,0,0,1
28.12.2018,Чикаго,Миннесота,1,2,2,0,0,5,1,0,1,0,0,2
28.12.2018,Эдмонтон,Ванкувер,1,1,0,0,0,2,4,0,0,0,0,4
28.12.2018,Вегас,Колорадо,1,0,1,0,0,2,1,0,0,0,0,1
28.12.2018,Сан-Хосе,Анахайм,1,1,2,0,0,4,1,0,1,0,0,2
28.12.2018,Лос-Анджелес,Аризона,1,0,1,0,0,2,1,0,0,0,0,1
29.12.2018,Коламбус,Торонто,1,0,1,0,0,2,2,1,1,0,0,4
29.12.2018,Айлендерс,Оттава,0,2,4,0,0,6,1,2,0,0,0,3
29.12.2018,Флорида,Монреаль,2,0,1,0,0,3,2,0,3,0,0,5
29.12.2018,Нью-Джерси,Каролина,0,1,1,0,0,2,0,0,0,0,0,0
30.12.2018,Виннипег,Миннесота,0,0,1,0,0,1,1,1,1,0,0,3
30.12.2018,Лос-Анджелес,Вегас,1,0,0,0,0,1,1,1,2,0,0,4
30.12.2018,Эдмонтон,Сан-Хосе,1,0,3,0,0,4,2,2,3,0,0,7
30.12.2018,Оттава,Вашингтон,0,1,1,0,0,2,2,1,0,0,0,3
30.12.2018,Флорида,Филадельфия,0,0,2,0,0,2,1,0,0,0,0,1
30.12.2018,Баффало,Бостон,1,1,0,0,0,2,1,0,1,1,0,3
30.12.2018,Торонто,Айлендерс,0,0,0,0,0,0,1,3,0,0,0,4
30.12.2018,Тампа-Бэй,Монреаль,2,2,2,0,0,6,3,2,0,0,0,5
30.12.2018,Сент-Луис,Питтсбург,0,1,0,0,0,1,1,3,2,0,0,6
30.12.2018,Даллас,Детройт,0,3,2,0,0,5,0,0,1,0,0,1
30.12.2018,Нэшвилл,Рейнджерс,1,2,0,0,0,3,1,1,2,0,0,4
30.12.2018,Колорадо,Чикаго,1,1,0,0,0,2,2,0,0,1,0,3
30.12.2018,Анахайм,Аризона,2,2,0,0,0,4,1,3,0,1,0,5
30.12.2018,Калгари,Ванкувер,1,1,0,0,0,2,1,1,0,1,0,3
31.12.2018,Аризона,Вегас,0,1,0,0,0,1,1,1,3,0,0,5
31.12.2018,Вашингтон,Нэшвилл,2,1,0,0,0,3,1,3,2,0,0,6
31.12.2018,Нью-Джерси,Ванкувер,2,0,2,0,0,4,0,0,0,0,0,0
01.01.2019,Баффало,Айлендерс,0,0,1,0,0,1,0,1,2,0,0,3
01.01.2019,Миннесота,Питтсбург,1,0,1,0,0,2,2,1,0,0,0,3
01.01.2019,Каролина,Филадельфия,1,2,0,0,0,3,0,0,1,0,0,1
01.01.2019,Коламбус,Оттава,0,1,5,0,0,6,0,1,2,0,0,3
01.01.2019,Сент-Луис,Рейнджерс,1,0,0,0,0,1,1,1,0,0,0,2
01.01.2019,Детройт,Флорида,3,0,0,0,0,3,0,3,0,0,1,4
01.01.2019,Колорадо,Лос-Анджелес,0,0,2,0,0,2,0,2,0,1,0,3
01.01.2019,Анахайм,Тампа-Бэй,1,0,0,0,0,1,1,0,0,1,0,2
01.01.2019,Даллас,Монреаль,0,2,0,0,0,2,1,0,1,1,0,3
01.01.2019,Эдмонтон,Виннипег,1,1,1,0,0,3,0,3,1,0,0,4
01.01.2019,Калгари,Сан-Хосе,3,2,3,0,0,8,1,2,2,0,0,5
01.01.2019,Чикаго,Бостон,1,1,0,0,0,2,1,1,2,0,0,4
02.01.2019,Нэшвилл,Филадельфия,0,2,2,0,0,4,0,0,0,0,0,0
02.01.2019,Вегас,Лос-Анджелес,0,0,2,0,0,2,0,0,0,0,0,0
03.01.2019,Детройт,Калгари,2,1,0,0,0,3,0,3,2,0,0,5
03.01.2019,Рейнджерс,Питтсбург,0,1,1,0,0,2,0,4,3,0,0,7
03.01.2019,Оттава,Ванкувер,0,1,2,0,0,3,0,2,1,1,0,4
03.01.2019,Даллас,Нью-Джерси,1,3,1,0,0,5,1,3,0,0,0,4
03.01.2019,Аризона,Эдмонтон,1,0,0,0,0,1,0,2,1,0,0,3
03.01.2019,Колорадо,Сан-Хосе,1,1,2,0,0,4,2,3,0,0,0,5
03.01.2019,Торонто,Миннесота,2,1,0,0,0,3,1,2,1,0,0,4
04.01.2019,Филадельфия,Каролина,0,0,3,0,0,3,0,3,2,0,0,5
04.01.2019,Бостон,Калгари,2,1,3,0,0,6,1,1,2,0,0,4
04.01.2019,Баффало,Флорида,2,0,2,0,0,4,0,1,2,0,0,3
04.01.2019,Монреаль,Ванкувер,1,1,0,0,0,2,0,0,0,0,0,0
04.01.2019,Айлендерс,Чикаго,1,1,0,1,0,3,1,0,1,0,0,2
04.01.2019,Сент-Луис,Вашингтон,1,2,2,0,0,5,1,1,0,0,0,2
04.01.2019,Лос-Анджелес,Тампа-Бэй,0,1,1,0,0,2,3,2,1,0,0,6
05.01.2019,Питтсбург,Виннипег,2,1,1,0,0,4,0,0,0,0,0,0
05.01.2019,Каролина,Коламбус,2,1,1,0,0,4,0,2,0,0,0,2
05.01.2019,Детройт,Нэшвилл,0,2,1,1,0,4,1,1,1,0,0,3
05.01.2019,Даллас,Вашингтон,1,0,0,1,0,2,0,1,0,0,0,1
05.01.2019,Аризона,Нью-Джерси,1,1,0,0,0,2,1,1,0,0,1,3
05.01.2019,Колорадо,Рейнджерс,2,1,3,0,0,6,0,0,1,0,0,1
05.01.2019,Анахайм,Вегас,0,2,0,0,0,2,1,2,0,0,0,3
05.01.2019,Оттава,Миннесота,1,1,1,0,0,3,0,3,1,0,0,4
05.01.2019,Филадельфия,Калгари,1,0,1,0,0,2,0,1,1,1,0,3
06.01.2019,Бостон,Баффало,1,1,0,0,0,2,0,0,1,0,0,1
06.01.2019,Торонто,Ванкувер,2,0,3,0,0,5,0,0,0,0,0,0
06.01.2019,Флорида,Коламбус,2,0,1,0,0,3,1,1,1,1,0,4
06.01.2019,Монреаль,Нэшвилл,0,1,0,0,0,1,2,1,1,0,0,4
06.01.2019,Сент-Луис,Айлендерс,2,0,1,0,0,3,0,1,3,0,0,4
06.01.2019,Лос-Анджелес,Эдмонтон,3,0,1,0,0,4,0,0,0,0,0,0
06.01.2019,Сан-Хосе,Тампа-Бэй,2,1,2,0,0,5,1,1,0,0,0,2
06.01.2019,Оттава,Каролина,0,4,0,0,0,4,2,2,1,0,0,5
07.01.2019,Вегас,Нью-Джерси,1,2,0,0,0,3,2,0,0,0,0,2
07.01.2019,Аризона,Рейнджерс,2,3,0,0,0,5,0,0,0,0,0,0
07.01.2019,Виннипег,Даллас,0,2,3,0,0,5,0,1,0,0,0,1
07.01.2019,Детройт,Вашингтон,1,1,0,0,0,2,1,0,2,0,0,3
07.01.2019,Питтсбург,Чикаго,2,1,0,0,0,3,1,2,2,0,0,5
07.01.2019,Анахайм,Эдмонтон,0,0,0,0,0,0,3,1,0,0,0,4
08.01.2019,Торонто,Нэшвилл,0,0,0,0,0,0,0,2,2,0,0,4
08.01.2019,Филадельфия,Сент-Луис,0,0,0,0,0,0,0,1,2,0,0,3
08.01.2019,Монреаль,Миннесота,0,0,0,0,0,0,0,0,1,0,0,1
08.01.2019,Чикаго,Калгари,1,1,1,0,0,3,1,1,2,0,0,4
08.01.2019,Сан-Хосе,Лос-Анджелес,1,1,1,0,0,3,0,1,0,0,0,1
09.01.2019,Айлендерс,Каролина,1,0,2,0,0,3,2,0,2,0,0,4
09.01.2019,Бостон,Миннесота,3,1,0,0,0,4,0,0,0,0,0,0
09.01.2019,Баффало,Нью-Джерси,0,5,0,0,0,5,1,0,0,0,0,1
09.01.2019,Питтсбург,Флорида,2,2,1,0,0,5,0,1,0,0,0,1
09.01.2019,Вашингтон,Филадельфия,1,3,1,0,0,5,1,0,2,0,0,3
09.01.2019,Тампа-Бэй,Коламбус,2,0,2,0,0,4,0,0,0,0,0,0
09.01.2019,Детройт,Монреаль,0,1,1,0,0,2,0,2,1,0,0,3
09.01.2019,Виннипег,Колорадо,2,2,3,0,0,7,1,2,1,0,0,4
09.01.2019,Сент-Луис,Даллас,0,1,0,0,0,1,1,2,0,0,0,3
09.01.2019,Вегас,Рейнджерс,1,2,1,0,0,4,0,0,2,0,0,2
09.01.2019,Сан-Хосе,Эдмонтон,3,2,2,0,0,7,1,1,0,0,0,2
10.01.2019,Чикаго,Нэшвилл,1,1,1,0,0,3,2,1,0,1,0,4
10.01.2019,Калгари,Колорадо,2,1,2,0,0,5,2,0,1,0,0,3
10.01.2019,Анахайм,Оттава,1,0,0,0,0,1,0,0,1,1,0,2
11.01.2019,Нью-Джерси,Торонто,0,2,0,0,0,2,3,0,1,0,0,4
11.01.2019,Филадельфия,Даллас,0,2,0,0,0,2,0,0,1,0,0,1
11.01.2019,Бостон,Вашингтон,0,1,1,0,0,2,1,1,2,0,0,4
11.01.2019,Рейнджерс,Айлендерс,1,1,1,0,0,3,2,1,1,0,0,4
11.01.2019,Коламбус,Нэшвилл,1,0,2,1,0,4,0,0,3,0,0,3
11.01.2019,Тампа-Бэй,Каролина,0,0,3,0,0,3,0,1,0,0,0,1
11.01.2019,Миннесота,Виннипег,1,2,0,0,0,3,0,1,1,0,0,2
11.01.2019,Сент-Луис,Монреаль,2,1,1,0,0,4,0,1,0,0,0,1
11.01.2019,Эдмонтон,Флорида,1,1,1,0,1,4,1,1,1,0,0,3
11.01.2019,Вегас,Сан-Хосе,1,0,1,0,0,2,0,1,2,0,0,3
11.01.2019,Ванкувер,Аризона,0,2,1,0,0,3,0,2,1,1,0,4
11.01.2019,Лос-Анджелес,Оттава,0,1,0,0,0,1,0,2,2,0,0,4
12.01.2019,Каролина,Баффало,1,3,0,0,0,4,1,1,1,0,0,3
12.01.2019,Виннипег,Детройт,2,1,1,0,0,4,0,1,1,0,0,2
12.01.2019,Калгари,Флорида,0,2,2,0,0,4,1,1,1,0,0,3
12.01.2019,Анахайм,Питтсбург,3,1,0,0,0,4,0,3,4,0,0,7
12.01.2019,Айлендерс,Рейнджерс,0,1,0,0,0,1,0,1,1,0,0,2
12.01.2019,Нью-Джерси,Филадельфия,1,1,1,0,0,3,0,1,1,0,0,2
13.01.2019,Монреаль,Колорадо,0,0,3,0,0,3,0,0,0,0,0,0
13.01.2019,Баффало,Тампа-Бэй,2,0,1,0,0,3,1,1,3,0,0,5
13.01.2019,Вашингтон,Коламбус,0,0,1,0,0,1,1,0,0,1,0,2
13.01.2019,Торонто,Бостон,0,2,0,0,0,2,1,2,0,0,0,3
13.01.2019,Миннесота,Детройт,1,1,0,0,0,2,1,2,2,0,0,5
13.01.2019,Чикаго,Вегас,2,1,0,0,0,3,0,2,1,1,0,4
13.01.2019,Даллас,Сент-Луис,0,0,1,0,0,1,2,0,1,0,0,3
13.01.2019,Эдмонтон,Аризона,1,1,0,0,0,2,0,2,1,0,0,3
13.01.2019,Сан-Хосе,Оттава,0,1,3,0,0,4,0,0,1,0,0,1
13.01.2019,Лос-Анджелес,Питтсбург,1,2,2,0,0,5,1,0,1,0,0,2
13.01.2019,Каролина,Нэшвилл,2,3,1,0,0,6,0,2,1,0,0,3
14.01.2019,Виннипег,Анахайм,1,1,1,1,0,4,2,1,0,0,0,3
14.01.2019,Коламбус,Рейнджерс,2,3,2,0,0,7,2,1,2,0,0,5
14.01.2019,Айлендерс,Тампа-Бэй,3,1,1,0,0,5,0,1,0,0,0,1
14.01.2019,Ванкувер,Флорида,0,1,4,0,0,5,0,0,1,0,0,1
14.01.2019,Калгари,Аризона,2,2,3,0,0,7,0,1,0,0,0,1
15.01.2019,Вашингтон,Сент-Луис,1,0,0,0,0,1,0,3,1,0,0,4
15.01.2019,Нью-Джерси,Чикаго,1,5,2,0,0,8,0,3,2,0,0,5
15.01.2019,Торонто,Колорадо,0,2,1,0,0,3,0,3,3,0,0,6
15.01.2019,Филадельфия,Миннесота,2,3,2,0,0,7,2,1,1,0,0,4
15.01.2019,Бостон,Монреаль,1,0,1,0,0,2,1,1,0,1,0,3
15.01.2019,Эдмонтон,Баффало,3,2,2,0,0,7,2,0,0,0,0,2
16.01.2019,Коламбус,Нью-Джерси,3,1,0,0,0,4,0,1,0,0,0,1
16.01.2019,Айлендерс,Сент-Луис,1,0,0,1,0,2,0,0,1,0,0,1
16.01.2019,Рейнджерс,Каролина,3,1,2,0,0,6,1,0,1,0,0,2
16.01.2019,Детройт,Анахайм,0,0,3,0,0,3,0,1,0,0,0,1
16.01.2019,Монреаль,Флорида,0,3,2,0,0,5,1,0,0,0,0,1
16.01.2019,Виннипег,Вегас,0,2,2,0,0,4,0,0,1,0,0,1
16.01.2019,Нэшвилл,Вашингтон,2,4,1,0,0,7,0,1,1,0,0,2
16.01.2019,Миннесота,Лос-Анджелес,0,1,1,0,1,3,0,1,1,0,0,2
16.01.2019,Даллас,Тампа-Бэй,0,0,0,0,0,0,1,0,1,0,0,2
16.01.2019,Сан-Хосе,Питтсбург,2,1,2,0,0,5,1,0,1,0,0,2
17.01.2019,Оттава,Колорадо,0,3,2,0,0,5,0,1,1,0,0,2
17.01.2019,Филадельфия,Бостон,1,2,1,0,0,4,2,0,1,0,0,3
17.01.2019,Калгари,Баффало,1,0,2,0,0,3,0,1,2,1,0,4
17.01.2019,Аризона,Сан-Хосе,2,2,2,0,0,6,1,1,1,0,0,3
17.01.2019,Ванкувер,Эдмонтон,1,1,0,0,0,2,2,0,0,0,1,3
18.01.2019,Рейнджерс,Чикаго,2,1,1,0,0,4,1,0,2,0,0,3
18.01.2019,Айлендерс,Нью-Джерси,3,0,1,0,0,4,0,0,1,0,0,1
18.01.2019,Бостон,Сент-Луис,0,2,3,0,0,5,0,2,0,0,0,2
18.01.2019,Тампа-Бэй,Торонто,1,1,0,0,0,2,1,2,1,0,0,4
18.01.2019,Нэшвилл,Виннипег,0,1,0,0,0,1,1,2,2,0,0,5
18.01.2019,Миннесота,Анахайм,0,0,0,0,0,0,3,0,0,0,0,3
18.01.2019,Даллас,Лос-Анджелес,0,0,1,0,0,1,1,1,0,0,0,2
19.01.2019,Коламбус,Монреаль,0,0,1,0,0,1,1,1,2,0,0,4
19.01.2019,Флорида,Торонто,2,0,1,0,0,3,1,0,0,0,0,1
19.01.2019,Каролина,Оттава,0,1,0,0,0,1,1,3,0,0,0,4
19.01.2019,Вашингтон,Айлендерс,0,0,0,0,0,0,0,0,2,0,0,2
19.01.2019,Аризона,Питтсбург,1,0,1,0,0,2,0,2,0,1,0,3
19.01.2019,Калгари,Детройт,0,2,4,0,0,6,1,1,2,0,0,4
19.01.2019,Ванкувер,Баффало,2,1,1,0,0,4,1,2,0,0,0,3
19.01.2019,Нью-Джерси,Анахайм,1,0,1,0,0,2,2,0,1,0,0,3
19.01.2019,Колорадо,Лос-Анджелес,1,6,0,0,0,7,0,0,1,0,0,1
20.01.2019,Тампа-Бэй,Сан-Хосе,2,2,2,0,0,6,1,1,1,0,0,3
20.01.2019,Сент-Луис,Оттава,1,1,1,0,0,3,1,0,1,0,0,2
20.01.2019,Монреаль,Филадельфия,0,0,2,0,0,2,0,2,3,0,0,5
20.01.2019,Даллас,Виннипег,1,2,1,0,0,4,0,0,2,0,0,2
20.01.2019,Бостон,Рейнджерс,1,0,1,0,0,2,1,1,1,0,0,3
20.01.2019,Нэшвилл,Флорида,0,0,2,0,0,2,2,1,1,0,0,4
20.01.2019,Миннесота,Коламбус,2,0,0,0,0,2,0,1,0,0,0,1
20.01.2019,Вегас,Питтсбург,3,2,2,0,0,7,1,2,0,0,0,3
20.01.2019,Эдмонтон,Калгари,0,1,1,0,0,2,0,3,2,0,0,5
20.01.2019,Чикаго,Вашингтон,3,1,4,0,0,8,1,1,3,0,0,5
20.01.2019,Айлендерс,Анахайм,2,1,0,0,0,3,0,0,0,0,0,0
21.01.2019,Ванкувер,Детройт,1,0,2,0,0,3,0,2,0,0,0,2
21.01.2019,Торонто,Аризона,1,0,1,0,0,2,0,2,2,0,0,4
21.01.2019,Эдмонтон,Каролина,1,1,2,0,0,4,3,3,1,0,0,7
21.01.2019,Колорадо,Нэшвилл,0,1,0,0,0,1,0,3,1,0,0,4
22.01.2019,Лос-Анджелес,Сент-Луис,1,2,1,0,0,4,2,0,1,0,0,3
22.01.2019,Вегас,Миннесота,1,1,0,0,0,2,0,2,2,0,0,4
22.01.2019,Флорида,Сан-Хосе,1,1,4,0,0,6,0,2,0,0,0,2
23.01.2019,Вашингтон,Сан-Хосе,3,2,1,0,0,6,2,2,2,1,0,7
23.01.2019,Оттава,Аризона,0,1,1,0,0,2,1,2,0,0,0,3
23.01.2019,Чикаго,Айлендерс,0,2,0,0,1,3,1,1,0,0,0,2
23.01.2019,Эдмонтон,Детройт,0,0,2,0,0,2,0,2,1,0,0,3
23.01.2019,Калгари,Каролина,1,1,0,1,0,3,1,0,1,0,0,2
24.01.2019,Монреаль,Аризона,1,0,1,0,0,2,0,1,0,0,0,1
24.01.2019,Торонто,Вашингтон,1,2,3,0,0,6,1,1,1,0,0,3
24.01.2019,Колорадо,Миннесота,2,0,0,0,0,2,2,2,1,0,0,5
24.01.2019,Анахайм,Сент-Луис,1,0,0,0,0,1,1,2,2,0,0,5
24.01.2019,Вегас,Нэшвилл,1,0,0,0,0,1,0,2,0,0,0,2
24.01.2019,Ванкувер,Каролина,0,2,0,0,0,2,0,5,0,0,0,5
29.01.2019,Филадельфия,Виннипег,0,2,1,0,0,3,0,1,0,0,0,1
29.01.2019,Питтсбург,Нью-Джерси,0,1,2,0,0,3,2,2,2,0,0,6
30.01.2019,Бостон,Виннипег,2,0,1,0,0,3,1,0,2,0,1,4
30.01.2019,Коламбус,Баффало,1,3,0,0,0,4,3,1,1,0,0,5
30.01.2019,Рейнджерс,Филадельфия,0,0,0,0,0,0,1,0,0,0,0,1
31.01.2019,Питтсбург,Тампа-Бэй,3,1,0,0,0,4,0,0,2,0,0,2
31.01.2019,Даллас,Баффало,1,0,0,0,0,1,0,0,0,0,0,0
01.02.2019,Бостон,Филадельфия,1,1,0,0,0,2,1,0,1,1,0,3
01.02.2019,Нью-Джерси,Рейнджерс,2,0,1,0,0,3,1,1,2,0,0,4
01.02.2019,Виннипег,Коламбус,1,1,2,0,0,4,2,1,0,0,0,3
02.02.2019,Баффало,Чикаго,0,1,2,0,0,3,1,3,3,0,0,7
02.02.2019,Флорида,Нэшвилл,0,1,0,0,0,1,0,0,4,0,0,4
02.02.2019,Питтсбург,Оттава,2,1,2,0,0,5,0,1,2,0,0,3
02.02.2019,Вашингтон,Калгари,2,1,1,0,0,4,1,1,1,0,0,3
02.02.2019,Айлендерс,Тампа-Бэй,0,0,0,0,0,0,0,0,0,0,1,1
02.02.2019,Каролина,Вегас,1,2,2,0,0,5,1,1,0,0,0,2
02.02.2019,Детройт,Торонто,0,1,1,1,0,3,0,1,1,0,0,2
02.02.2019,Даллас,Миннесота,0,1,2,0,0,3,0,1,0,0,0,1
02.02.2019,Филадельфия,Эдмонтон,1,1,2,1,0,5,2,1,1,0,0,4
02.02.2019,Монреаль,Нью-Джерси,1,1,0,0,0,2,1,0,1,1,0,3
03.02.2019,Коламбус,Сент-Луис,0,0,2,0,0,2,2,0,2,0,0,4
03.02.2019,Айлендерс,Лос-Анджелес,1,0,3,0,0,4,1,0,1,0,0,2
03.02.2019,Флорида,Вегас,1,0,2,0,0,3,1,0,0,0,0,1
03.02.2019,Оттава,Детройт,0,0,0,0,0,0,2,0,0,0,0,2
03.02.2019,Виннипег,Анахайм,6,2,1,0,0,9,0,2,1,0,0,3
03.02.2019,Торонто,Питтсбург,1,2,0,0,0,3,2,0,0,0,0,2
03.02.2019,Нэшвилл,Даллас,1,0,0,0,0,1,1,0,2,0,0,3
03.02.2019,Рейнджерс,Тампа-Бэй,0,1,1,0,0,2,1,2,0,0,0,3
03.02.2019,Миннесота,Чикаго,1,0,2,0,0,3,0,2,1,1,0,4
03.02.2019,Колорадо,Ванкувер,0,1,0,0,0,1,2,2,1,0,0,5
03.02.2019,Сан-Хосе,Аризона,0,2,0,1,0,3,0,1,1,0,0,2
03.02.2019,Вашингтон,Бостон,0,0,0,0,0,0,0,1,0,0,0,1
03.02.2019,Каролина,Калгари,1,1,1,0,0,3,1,2,1,0,0,4
03.02.2019,Монреаль,Эдмонтон,1,1,1,1,0,4,1,2,0,0,0,3
05.02.2019,Рейнджерс,Лос-Анджелес,1,1,1,0,0,3,1,0,2,1,0,4
05.02.2019,Торонто,Анахайм,0,3,3,0,0,6,0,0,1,0,0,1
05.02.2019,Филадельфия,Ванкувер,1,1,0,0,0,2,0,1,0,0,0,1
05.02.2019,Даллас,Аризона,0,1,4,0,0,5,1,1,2,0,0,4
06.02.2019,Бостон,Айлендерс,0,1,2,0,0,3,0,1,0,0,0,1
06.02.2019,Питтсбург,Каролина,0,0,0,0,0,0,1,1,2,0,0,4
06.02.2019,Флорида,Сент-Луис,1,0,1,0,0,2,0,0,3,0,0,3
06.02.2019,Нью-Джерси,Лос-Анджелес,0,1,0,0,0,1,1,0,4,0,0,5
06.02.2019,Вашингтон,Ванкувер,1,0,2,0,0,3,0,0,2,0,0,2
06.02.2019,Баффало,Миннесота,1,2,1,0,1,5,0,3,1,0,0,4
06.02.2019,Монреаль,Анахайм,3,0,1,0,0,4,0,1,0,0,0,1
06.02.2019,Тампа-Бэй,Вегас,1,1,0,0,0,2,0,1,1,0,1,3
06.02.2019,Нэшвилл,Аризона,0,3,2,0,0,5,1,0,1,0,0,2
06.02.2019,Виннипег,Сан-Хосе,1,1,0,0,0,2,1,0,1,1,0,3
06.02.2019,Колорадо,Коламбус,2,1,0,0,0,3,2,1,3,0,0,6
06.02.2019,Эдмонтон,Чикаго,2,0,0,0,0,2,1,0,5,0,0,6
07.02.2019,Торонто,Оттава,1,3,1,0,0,5,1,1,2,0,0,4
07.02.2019,Рейнджерс,Бостон,1,0,2,0,1,4,0,3,0,0,0,3
08.02.2019,Вашингтон,Колорадо,1,1,1,1,0,4,0,1,2,0,0,3
08.02.2019,Флорида,Питтсбург,1,1,0,1,0,3,0,1,1,0,0,2
08.02.2019,Нью-Джерси,Айлендерс,1,0,0,0,0,1,1,0,0,0,1,2
08.02.2019,Баффало,Каролина,0,2,3,0,0,5,1,1,3,1,0,6
08.02.2019,Филадельфия,Лос-Анджелес,0,1,1,0,0,2,1,1,0,0,1,3
08.02.2019,Оттава,Анахайм,1,1,2,0,0,4,0,0,0,0,0,0
08.02.2019,Тампа-Бэй,Сент-Луис,0,0,0,0,0,0,0,0,0,1,0,1
08.02.2019,Детройт,Вегас,1,0,2,0,0,3,0,3,1,0,0,4
08.02.2019,Монреаль,Виннипег,1,1,3,0,0,5,1,0,1,0,0,2
08.02.2019,Нэшвилл,Даллас,1,0,1,1,0,3,0,0,2,0,0,2
08.02.2019,Миннесота,Эдмонтон,0,0,1,0,0,1,1,1,2,0,0,4
08.02.2019,Чикаго,Ванкувер,2,1,0,1,0,4,0,2,1,0,0,3
08.02.2019,Калгари,Сан-Хосе,1,1,0,0,0,2,3,1,1,0,0,5
08.02.2019,Аризона,Коламбус,0,2,0,0,0,2,2,1,1,0,0,4
09.02.2019,Рейнджерс,Каролина,0,0,0,0,0,0,0,0,3,0,0,3
09.02.2019,Нью-Джерси,Миннесота,1,0,1,0,0,2,1,2,1,0,0,4
09.02.2019,Баффало,Детройт,0,3,0,0,0,3,0,1,0,0,0,1
09.02.2019,Айлендерс,Колорадо,0,1,2,1,0,4,1,1,1,0,0,3
09.02.2019,Филадельфия,Анахайм,4,0,2,0,0,6,0,1,1,0,0,2
09.02.2019,Бостон,Лос-Анджелес,0,1,3,1,0,5,0,2,2,0,0,4
09.02.2019,Оттава,Виннипег,2,2,1,0,0,5,0,1,1,0,0,2
09.02.2019,Сент-Луис,Нэшвилл,2,1,0,0,0,3,0,1,1,0,0,2
10.02.2019,Аризона,Даллас,1,1,1,0,0,3,0,0,2,0,0,2
10.02.2019,Монреаль,Торонто,1,1,1,0,0,3,2,0,1,1,0,4
10.02.2019,Эдмонтон,Сан-Хосе,0,1,1,0,0,2,2,1,2,0,0,5
10.02.2019,Вашингтон,Флорида,0,2,2,0,0,4,2,1,1,1,0,5
10.02.2019,Тампа-Бэй,Питтсбург,2,1,2,0,0,5,1,2,1,0,0,4
10.02.2019,Вегас,Коламбус,2,0,1,0,0,3,1,1,2,0,0,4
10.02.2019,Ванкувер,Калгари,2,1,0,0,1,4,2,1,0,0,0,3
10.02.2019,Нэшвилл,Сент-Луис,0,1,3,0,0,4,0,3,1,1,0,5
10.02.2019,Баффало,Виннипег,0,1,0,0,0,1,0,1,2,0,0,3
10.02.2019,Нью-Джерси,Каролина,2,0,1,0,0,3,0,1,1,0,0,2
10.02.2019,Чикаго,Детройт,2,0,3,0,0,5,0,1,1,0,0,2
10.02.2019,Айлендерс,Миннесота,1,1,0,0,0,2,0,1,0,0,0,1
10.02.2019,Бостон,Колорадо,0,1,0,1,0,2,1,0,0,0,0,1
11.02.2019,Флорида,Тампа-Бэй,0,2,0,0,0,2,1,2,2,0,0,5
11.02.2019,Рейнджерс,Торонто,2,0,2,0,0,4,1,0,0,0,0,1
12.02.2019,Вашингтон,Лос-Анджелес,2,3,1,0,0,6,2,1,1,0,0,4
12.02.2019,Филадельфия,Питтсбург,0,0,1,0,0,1,1,1,2,0,0,4
12.02.2019,Ванкувер,Сан-Хосе,1,0,1,0,0,2,3,3,1,0,0,7
13.02.2019,Баффало,Айлендерс,1,1,1,0,0,3,1,0,0,0,0,1
13.02.2019,Коламбус,Вашингтон,0,1,2,0,0,3,0,0,0,0,0,0
13.02.2019,Флорида,Даллас,0,0,0,0,0,0,1,1,1,0,0,3
13.02.2019,Бостон,Чикаго,3,1,2,0,0,6,1,1,1,0,0,3
13.02.2019,Оттава,Каролина,1,0,0,0,0,1,0,0,4,0,0,4
13.02.2019,Тампа-Бэй,Калгари,3,2,1,0,0,6,1,1,1,0,0,3
13.02.2019,Сент-Луис,Нью-Джерси,3,3,2,0,0,8,1,0,2,0,0,3
13.02.2019,Нэшвилл,Детройт,0,2,0,0,0,2,1,1,1,0,0,3
13.02.2019,Миннесота,Филадельфия,3,0,1,0,0,4,1,2,2,0,0,5
13.02.2019,Виннипег,Рейнджерс,2,0,2,0,0,4,0,2,1,0,0,3
13.02.2019,Колорадо,Торонто,1,0,1,0,0,2,1,3,1,0,0,5
13.02.2019,Вегас,Аризона,0,2,0,0,0,2,0,2,3,0,0,5
14.02.2019,Питтсбург,Эдмонтон,0,2,1,0,0,3,1,0,0,0,0,1
14.02.2019,Анахайм,Ванкувер,1,0,0,0,0,1,0,0,0,0,0,0
15.02.2019,Коламбус,Айлендерс,0,0,0,0,0,0,1,2,0,0,0,3
15.02.2019,Флорида,Калгари,0,1,1,0,1,3,0,0,2,0,0,2
15.02.2019,Детройт,Оттава,2,1,0,0,0,3,1,1,0,0,0,2
15.02.2019,Тампа-Бэй,Даллас,4,2,0,0,0,6,0,0,0,0,0,0
15.02.2019,Виннипег,Колорадо,1,0,0,0,0,1,2,1,1,0,0,4
15.02.2019,Нэшвилл,Монреаль,0,1,2,0,0,3,0,0,1,0,0,1
15.02.2019,Чикаго,Нью-Джерси,1,2,2,0,0,5,2,0,0,0,0,2
15.02.2019,Аризона,Сент-Луис,0,0,0,0,0,0,2,1,1,0,0,4
15.02.2019,Вегас,Торонто,0,2,1,0,0,3,1,2,3,0,0,6
15.02.2019,Сан-Хосе,Вашингтон,1,0,0,0,0,1,2,2,1,0,0,5
15.02.2019,Лос-Анджелес,Ванкувер,1,1,1,0,0,3,1,1,1,0,1,4
16.02.2019,Баффало,Рейнджерс,0,2,0,0,0,2,2,1,3,0,0,6
16.02.2019,Каролина,Эдмонтон,2,0,1,0,0,3,1,0,0,0,0,1
16.02.2019,Миннесота,Нью-Джерси,2,2,0,0,0,4,0,2,2,1,0,5
16.02.2019,Анахайм,Бостон,0,0,0,0,0,0,1,1,1,0,0,3
16.02.2019,Питтсбург,Калгари,1,1,2,0,0,4,1,4,0,0,0,5
16.02.2019,Филадельфия,Детройт,1,2,2,1,0,6,1,0,4,0,0,5
16.02.2019,Колорадо,Сент-Луис,0,0,0,0,0,0,0,0,3,0,0,3
17.02.2019,Аризона,Торонто,0,2,0,0,0,2,0,0,0,0,0,0
17.02.2019,Айлендерс,Эдмонтон,0,2,3,0,0,5,0,1,1,0,0,2
17.02.2019,Виннипег,Оттава,2,0,1,0,0,3,1,1,1,1,0,4
17.02.2019,Тампа-Бэй,Монреаль,0,0,3,0,0,3,0,0,0,0,0,0
17.02.2019,Каролина,Даллас,2,0,1,0,0,3,0,0,0,0,0,0
17.02.2019,Чикаго,Коламбус,1,1,0,0,0,2,3,0,2,0,0,5
17.02.2019,Сан-Хосе,Ванкувер,1,1,1,0,0,3,1,0,1,0,0,2
17.02.2019,Вегас,Нэшвилл,1,1,3,0,0,5,0,0,1,0,0,1
17.02.2019,Лос-Анджелес,Бостон,0,1,1,0,0,2,1,1,2,0,0,4
17.02.2019,Питтсбург,Рейнджерс,1,2,3,0,0,6,1,2,2,0,0,5
17.02.2019,Миннесота,Сент-Луис,0,0,0,0,0,0,2,2,0,0,0,4
18.02.2019,Нью-Джерси,Баффало,0,2,2,0,0,4,0,1,0,0,0,1
18.02.2019,Детройт,Филадельфия,0,1,0,0,0,1,1,0,2,0,0,3
18.02.2019,Флорида,Монреаль,3,1,2,0,0,6,2,1,0,0,0,3
18.02.2019,Анахайм,Вашингтон,0,2,3,0,0,5,1,1,0,0,0,2
19.02.2019,Калгари,Аризона,1,2,2,0,0,5,0,2,0,0,0,2
19.02.2019,Коламбус,Тампа-Бэй,0,0,1,0,0,1,2,1,2,0,0,5
19.02.2019,Чикаго,Оттава,5,2,1,0,0,8,4,1,2,0,0,7
19.02.2019,Колорадо,Вегас,1,1,1,0,0,3,0,0,0,0,0,0
19.02.2019,Сан-Хосе,Бостон,1,3,1,0,0,5,3,1,1,1,0,6
19.02.2019,Лос-Анджелес,Вашингтон,0,0,2,0,0,2,2,1,0,0,0,3
20.02.2019,Нью-Джерси,Питтсбург,2,0,1,0,0,3,2,2,0,0,0,4
20.02.2019,Филадельфия,Тампа-Бэй,0,0,2,0,0,2,3,0,2,0,0,5
20.02.2019,Каролина,Рейнджерс,0,1,0,0,0,1,0,1,1,0,0,2
20.02.2019,Флорида,Баффало,0,0,4,0,0,4,0,1,1,0,0,2
20.02.2019,Монреаль,Коламбус,2,0,1,0,0,3,0,1,1,0,0,2
20.02.2019,Миннесота,Анахайм,0,0,0,0,0,0,0,1,3,0,0,4
20.02.2019,Сент-Луис,Торонто,2,0,0,1,0,3,0,0,2,0,0,2
20.02.2019,Даллас,Нэшвилл,0,3,0,0,0,3,1,2,2,0,0,5
20.02.2019,Эдмонтон,Аризона,0,0,2,0,0,2,0,1,1,0,1,3
21.02.2019,Детройт,Чикаго,1,0,3,0,0,4,3,1,0,1,0,5
21.02.2019,Колорадо,Виннипег,0,2,5,0,0,7,0,0,1,0,0,1
21.02.2019,Калгари,Айлендерс,2,0,2,0,0,4,0,1,1,0,0,2
21.02.2019,Вегас,Бостон,1,0,1,0,0,2,1,0,1,0,1,3
22.02.2019,Нью-Джерси,Оттава,2,2,0,0,0,4,0,0,0,0,0,0
22.02.2019,Торонто,Вашингтон,0,0,2,0,0,2,0,2,1,0,0,3
22.02.2019,Рейнджерс,Миннесота,0,1,0,0,0,1,1,1,2,0,0,4
22.02.2019,Флорида,Каролина,0,3,0,0,0,3,1,1,2,0,0,4
22.02.2019,Питтсбург,Сан-Хосе,0,0,0,0,0,0,3,0,1,0,0,4
22.02.2019,Монреаль,Филадельфия,3,2,0,0,0,5,0,0,1,0,0,1
22.02.2019,Тампа-Бэй,Баффало,0,1,0,0,1,2,1,0,0,0,0,1
22.02.2019,Нэшвилл,Лос-Анджелес,1,1,0,0,0,2,0,0,1,0,0,1
22.02.2019,Даллас,Сент-Луис,0,4,1,0,0,5,0,2,0,0,0,2
22.02.2019,Эдмонтон,Айлендерс,2,0,1,1,0,4,3,0,0,0,0,3
22.02.2019,Ванкувер,Аризона,1,0,1,0,0,2,0,0,2,1,0,3
23.02.2019,Оттава,Коламбус,0,0,0,0,0,0,1,0,2,0,0,3
23.02.2019,Чикаго,Колорадо,0,2,1,0,0,3,1,1,3,0,0,5
23.02.2019,Детройт,Миннесота,0,1,1,0,0,2,2,1,0,0,0,3
23.02.2019,Калгари,Анахайм,0,1,1,0,0,2,0,1,0,0,0,1
23.02.2019,Вегас,Виннипег,1,1,1,0,0,3,2,2,2,0,0,6
23.02.2019,Баффало,Вашингтон,2,1,2,0,0,5,0,1,1,0,0,2
23.02.2019,Рейнджерс,Нью-Джерси,3,0,2,0,0,5,0,0,2,0,0,2
24.02.2019,Сент-Луис,Бостон,1,0,0,0,1,2,0,1,0,0,0,1
24.02.2019,Флорида,Лос-Анджелес,1,3,2,0,0,6,1,0,0,0,0,1
24.02.2019,Коламбус,Сан-Хосе,1,2,1,0,0,4,0,0,0,0,0,0
24.02.2019,Даллас,Каролина,0,0,0,0,0,0,1,1,1,0,0,3
24.02.2019,Нэшвилл,Колорадо,0,0,0,0,0,0,1,2,2,0,0,5
24.02.2019,Торонто,Монреаль,0,2,4,0,0,6,3,0,0,0,0,3
24.02.2019,Филадельфия,Питтсбург,1,0,2,1,0,4,1,1,1,0,0,3
24.02.2019,Ванкувер,Айлендерс,0,0,0,0,0,0,2,0,2,0,0,4
24.02.2019,Эдмонтон,Анахайм,1,1,0,0,0,2,0,1,0,0,0,1
24.02.2019,Вашингтон,Рейнджерс,2,1,2,1,0,6,1,1,3,0,0,5
24.02.2019,Чикаго,Даллас,0,2,1,0,0,3,2,1,1,0,0,4
24.02.2019,Детройт,Сан-Хосе,2,1,0,0,0,3,1,3,1,0,0,5
25.02.2019,Миннесота,Сент-Луис,0,1,0,1,0,2,0,0,1,0,0,1
25.02.2019,Оттава,Калгари,0,1,0,0,0,1,1,0,1,0,0,2
25.02.2019,Аризона,Виннипег,1,2,1,0,0,4,1,0,0,0,0,1
26.02.2019,Нью-Джерси,Монреаль,1,1,0,0,0,2,0,0,1,0,0,1
26.02.2019,Торонто,Баффало,0,4,1,0,0,5,1,1,1,0,0,3
26.02.2019,Тампа-Бэй,Лос-Анджелес,2,0,1,0,1,4,0,0,3,0,0,3
26.02.2019,Нэшвилл,Эдмонтон,0,2,0,0,1,3,1,0,1,0,0,2
26.02.2019,Колорадо,Флорида,0,2,1,0,0,3,0,2,1,1,0,4
26.02.2019,Ванкувер,Анахайм,2,1,1,0,0,4,0,0,0,0,0,0
27.02.2019,Филадельфия,Баффало,2,1,2,0,0,5,1,1,0,0,0,2
27.02.2019,Бостон,Сан-Хосе,1,3,0,0,0,4,1,0,0,0,0,1
27.02.2019,Коламбус,Питтсбург,0,2,0,0,0,2,2,1,2,0,0,5
27.02.2019,Каролина,Лос-Анджелес,2,4,0,0,0,6,0,0,1,0,0,1
27.02.2019,Вашингтон,Оттава,2,4,1,0,0,7,2,0,0,0,0,2
27.02.2019,Айлендерс,Калгари,0,1,0,0,0,1,0,1,2,0,0,3
27.02.2019,Детройт,Монреаль,0,1,0,0,0,1,1,5,2,0,0,8
27.02.2019,Сент-Луис,Нэшвилл,0,0,2,0,0,2,0,0,0,0,0,0
27.02.2019,Виннипег,Миннесота,1,1,0,0,0,2,0,1,2,0,0,3
27.02.2019,Аризона,Флорида,0,2,1,0,1,4,0,1,2,0,0,3
27.02.2019,Вегас,Даллас,0,1,3,0,0,4,1,0,0,0,0,1
28.02.2019,Торонто,Эдмонтон,1,4,1,0,0,6,1,0,1,0,0,2
28.02.2019,Нью-Джерси,Калгари,0,1,0,0,0,1,0,2,0,0,0,2
28.02.2019,Рейнджерс,Тампа-Бэй,0,3,0,0,0,3,2,1,0,1,0,4
28.02.2019,Колорадо,Ванкувер,2,0,0,0,1,3,1,0,1,0,0,2
28.02.2019,Анахайм,Чикаго,0,2,1,0,0,3,0,2,2,0,0,4
01.03.2019,Айлендерс,Торонто,1,3,2,0,0,6,1,0,0,0,0,1
01.03.2019,Коламбус,Филадельфия,1,1,1,1,0,4,2,0,1,0,0,3
01.03.2019,Бостон,Тампа-Бэй,0,1,3,0,0,4,0,0,1,0,0,1
01.03.2019,Оттава,Эдмонтон,1,0,1,0,0,2,0,2,2,0,0,4
01.03.2019,Аризона,Ванкувер,2,2,1,0,0,5,1,0,1,0,0,2
01.03.2019,Вегас,Флорида,1,3,1,0,1,6,3,1,1,0,0,5
01.03.2019,Лос-Анджелес,Даллас,2,1,0,0,0,3,1,1,1,1,0,4
